X	X and is in rays chromosome of to or has was are The for ray axis on chromosomes as will can the with THE Y at be syndrome by A from Window that had may would a Corps I which Corporation values must does server x represents were Company value n have into if should i direction B number In Windows could o C g This but y when such V Figure XX O variable increases where being stock s DNA See Fig we did S N XXX indicates denotes variables per coordinate also then E e over because who might about inactivation through he mark chart factor c T receptor P Rays M under than As Server takes shows denote No contains said time It gives H equals dollars it given m v stands causes r only et R becomes f so XI Library AND D percent Printed system amount All For marks between appears t Total L means CO corporation there Ray do band distance register after before represent radiation scale without not film made equal Games b matrix J makes itself lO occurs If shall scores applications io group cells New an position To says provides F units p phage no Microsoft Time Toolkit times gene years window falls lies IN collagen irradiation Speaks Table plus Number using First during On rather exists Syndrome knows IS II magnification component W line U data next depends changes OF length point type above now client Q d against his one within sex K uses came century Factor requires Files de score protein G We nor repressor l refers whose while SSC Copyright having terminal HE cup VALUE used light Z program includes Pan button cos Bank Ibid VI When comes versus sin believes bond range linked instead clients rating version across below varies alone TO FIGURE deficiency Chromosome From owns family goes consists along u died Of An environment application atoms model more became Not wants International Consortium case At There Other Sex Axis belongs Ltd ought Volume gave total column defined remains k height College respectively corresponds sells protocol series Price High How ON standard area disease Is took decreases distribution onto inch Group days am He company all VIII himself assumes vector follows here told width volume approaches terminals University servers RAYS j ft satisfies project until Springer produced relative produces These out mental called ISBN acceleration Club programs h And weight Age w you went females set this state according la file z General receives gets holds mean again Note amperes received session el Chapter corresponding offers Variable Data Vi seems sold Vol moves One Yes always change State What Standard hours CD implies rate Some since Do Value ratio School pattern upon diagram velocity points found input Rate leads rises coordinates control Pictures plane left obtained configuration key By Published display windows mode TABLE assumptions command chains first form even National Paired purchased CHAPTER test just Average its John unit Congresso Fretensis co never males age results open Source issued class VII tells show Tiger RAY receptors really began Position still average Cancel max region Family normal systems minus SD files need en Master due less states shape But Range cell That
XA	and cup is teaspoon inch
XANES	spectra
XB	and is
XCOPY	command
XEROX	CORPORATION
XHIe	siecle
XHIth	century
XHTML	document documents is and Basic
XI	of and THE The in to A is was Corps I century had on XII for are V the International shows as or at deficiency In that has II were with a by e CHAPTER et IN which gives OF we will It
XII	of and THE The in century to was A Tables Corps is had on I for are at the as shows or International In XIII a has that were with by e secolo et IN deficiency did It gives
XIII	and THE of The in century to Corps A was had is on for the I International e are as shows deficiency secolo a that et In XIV has at Century with al were or by IN issued It
XIIIe	siecle
XIIIth	century
XIIe	siecle et
XIIth	Dynasty century dynasty
XIT	Ranch
XIV	and of THE in was The had to century A Corps is the as at on for et that or were by would with International e a style are shows did himself siecle I Panzer secolo could In made who Century from died which took al s IN
XIVe	siecle
XIVth	century
XIX	THE of The century and Century Corps veka A secolo siecle i y in is to TAC wieku International I shows
XIXe	siecle et Siecle siecles
XIXth	century
XIe	siecle
XL	VI VII VIII The THE and of is A in
XLANG	schedule
XLI	THE The of
XLII	THE of
XLIII	of THE
XLIV	THE
XLV	of
XLVII	Panzer
XM	Satellite and
XML	document documents file data Schema and is schema Web files format to in parser element elements Document for as tags Data schemas declaration Schemas syntax Documents Signature content with object can or representation has processor that processing from tree parsers DOM into code specification database Encryption query namespace structure configuration namespaces support instance application markup source applications messages tag output technologies based DTD File standard message Query parsing are language editor web fragment was standards provides will version serialization using databases Parser AUTO string text node Processing attribute attributes allows vocabulary technology tools does Path by Namespaces stream XML comments view The nodes Source formats queries
XMLHttpRequest	object
XMS	memory
XO	and
XOR	gate gates operation function of and problem
XORed	with
XP	Professional and Home is to or in has computer operating will can displays CD with does Service on server system installation are cells Pro includes that for provides Media desktop as servers patients applications
XPS	spectra and analysis data spectrum measurements is results studies
XPath	expression expressions is query and queries
XQ	is and
XQuery	is
XRD	patterns pattern and analysis data spectra results measurements peaks of analyses
XRF	analysis and
XSD	schema
XSL	style stylesheet Transformations file is
XSLT	processor stylesheet is and style to transformation stylesheets
XT	and is or
XTV	of
XV	and of THE The century Corps in was to A had III is e style et I Century for on the secolo siecle International shows at are as th period Style that a Carved or al furniture with y were
XVI	and THE of The century was in to had A I Century y style is e on secolo II Corps a the as for International al at XVII i shows are that period siecle Ith In were or et
XVII	THE of The and century A Century Corps I in veka to y secolo XVIII e is International wieku shows was on
XVIII	THE of and Century The century Airborne A Corps veka was to in secolo had siecle is wieku i on Dynasty shows e XIX International I y centuries for
XVIIIe	siecle siecles et Siecle
XVIIIth	century Dynasty Century dynasty and
XVIIe	siecle et siecles
XVIIth	century Century and
XVIe	siecle et au siecles
XVIth	century Century and
XVe	siecle et siecles au
XVle	siecle
XVth	century Century International Centuries and
XX	of and THE XX The X Corps is in A century veka or XXX Settembre to males secolo wieku Century for I are VII was sex chromosomes females the Congress VIII male
XXI	THE of The and A Corps Editores I in Bomber is II to
XXII	THE of and The A in to I was
XXIII	THE and of The in to A was had on is Corps
XXIV	THE of Corps The and A
XXIX	THE The of and A
XXV	THE of The and A
XXVI	THE of The and A I
XXVII	THE of The and A
XXVIII	THE of The and A
XXX	XXX Corps X THE The of and XX A is Cantos in I
XXXI	THE of The and A I
XXXII	THE of The and A
XXXIII	THE of The Corps and
XXXIV	THE of The and
XXXIX	Articles THE of The and
XXXV	THE of The and
XXXVI	THE of The and
XXXVII	THE of The and
XXXVIII	THE of The and
XXXX	XXXX X
XXXXX	XXXXX
XXY	and
XXe	siecle siecles Siecle
XXth	century Century Corps Congress Dynasty
XY	plane and is in sex model males gonadal karyotype chromosomes Company females or graph pair individuals chromosome male
XYY	males syndrome and chromosome male men
XYZ	Company Corporation is Affair stock and affair has to at company in will Bank COMPANY system of
XZ	plane
Xa	and is activity Hoi Loi
Xanadu	did
Xanana	Gusmao
Xanax	and
Xand	Y
Xander	and said
Xanthan	gum
Xanthine	oxidase Oxidase
Xanthium	strumarium
Xanthogranulomatous	pyelonephritis
Xanthomonas	campestris oryzae
Xanthoria	parietina
Xanthus	and
Xaver	Kroetz
Xavier	University de and was del had in College to Cugat is said Bichat Herbert Sala Villaurrutia Church at of Cabrini Vallat Mission Martin on as has High
Xba	I
Xbox	Live
Xc	is and are
Xe	and siecle is in atoms
XeCl	laser excimer
Xenia	and was
Xenocrates	and
Xenon	arc lamp
Xenophanes	and of was
Xenophobia	and in
Xenophon	and was in is of had has to says himself tells the as does or on describes gives wrote
Xenopsylla	cheopis
Xenopus	laevis oocytes embryos oocyte eggs egg and embryo
Xeres	de
Xeroderma	pigmentosum Pigmentosum
Xerox	Corporation PARC and machine Palo University copy copies was has is in had Company machines to of College Network Education Star or copier
Xers	are and
Xerxes	was and had in to I is the at himself of would as on with
Xew	York England Jersey Zealand Orleans
Xf	is
Xg	blood and
Xho	I
Xhosa	and people in were chiefs had to
Xi	and is Delta are in to Chapter of was chapter for has Xia as on at Lu with Shi the
Xia	and et Yan dynasty Dynasty
Xiamen	University and
Xian	and
Xiang	Yu and River Ying Jingyu Fu
Xiao	and et Hong Ping Jun
Xiaoping	and in was had to has is
Xie	and et Jin
Xieng	Khouang
Xilinx	Virtex
Ximen	Qing
Ximenes	de and was had in
Ximenez	de
Xin	and
Xing	Distripark and
Xingu	River and
Xinhua	News
Xinjiang	and Uygur in province Province is Autonomous to was
Xiong	et and
Xipe	Totec
Xiphias	gladius
Xiphoid	process
Xiphophorus	helleri maculatus
Xizang	Plateau
Xj	is and are in
Xk	is and
Xl	and is
XlVe	siecle et
XlVth	century and Century
XlXth	century Century Dynasty
Xle	siecle et
Xlib	function
Xlibris	Corporation
Xlle	siecle et
Xllle	siecle
Xlllth	century
Xllth	century Dynasty
Xlth	International century
Xm	is and
Xmas	and Day day Eve tree
XmlDocument	class
Xn	is and are
Xo	is one and
Xochimilco	and
Xorth	America Carolina
Xot	only
Xp	and is
Xpress	Pro
Xq	is
Xr	is
Xray	diffraction
Xs	and are is in on to
Xt	is and John are Intrinsics in
Xth	International century Corps
Xu	and et was Bing Guangqi is Wei Xiangqian Zhimo Beihong Shen
Xuan	Thuy Loc Zang and
Xuat	Ban
Xue	and Muqiao et Litai
Xulon	Press
Xun	and was Zi had
Xunta	de
Xx	and is
x	and is in axis to x of direction for from the are as or n g has rays can with at be will mark by The a that on values such which e y B may N increases represents coordinate must A value was component X m number I ray i does into would we time if being where In between denotes per p when S units C represent E years s SSC M approaches equal but G r equals This should were only distance Fig Figure lO As times height becomes along T P dollars V c have percent variable t R k magnification width so It then belongs denote over L b Time it gives io varies l D given stands andy length there f exists List indicates o lies could J d cos about variables sin environment Introduction position changes H coordinates K means U W v Rs cm occurs hours F under Sex because than within successes amount after using itself age alone Number appears total If versus not through chart an satisfies For Preface velocity decreases takes stroke area acceleration depends days hybrida components plus Total corresponding contains We no one had sex without line long inches greater Y But might average volume Rate treatment corresponds min tends also before above diameter standard satisfying Standard respectively O less weight believes normal refers depth causes against h To SU according j log rather its instead plane whose distribution goes Age he factor co See feet He rate And Q while yields II gets option w Chapter LIST falls more curve due column sec do seconds axes defined below minutes region radiation u objective term ranges ca near mean data There remains diagram constant measured CHAPTER Actual scale thick q intermedia year At FIGURE this day intercept range having during miles et nor temperature up location relative frequency On Vi dependence TBE When space These descent obtained who thickness moles Thus function z density Acknowledgements two months points since dimension body Table Average specific phase radius From terms moves cost ft Treatment shows No positive pounds knows New used unit stand quantity GPA test makes out except Distance ml
xA	and
xL	of
xa	and is hoi
xand	y
xanthan	gum
xanthate	is and
xanthin	bases
xanthine	oxidase dehydrogenase and derivatives to
xanthogranulomatous	pyelonephritis
xanthoma	cells
xanthophyll	cycle
xanthurenic	acid
xc	is and
xe	is
xenobiotic	metabolism compounds
xenobiotics	in and are
xenograft	rejection model models survival
xenografts	in of
xenoliths	of from in are and
xenon	arc and lamp gas in is flash atoms lamps are light or at
xenophobia	and in of that is was which
xenophobic	and nationalism attitudes
xeroderma	pigmentosum
xerographic	process copy print
xerographically	in
xerography	in on
xerophthalmia	and
xerophytic	plants vegetation
xerostomia	and
xerotica	obliterans
xerox	copy copies
xf	is and
xg	of for per
xh	cup
xi	and Introduction Preface is Acknowledgments List Chapter of CHAPTER PART in Foreword The Part to are Acknowledgements INTRODUCTION Abbreviations I LIST for the A as Prologue i
xii	and Introduction of List Preface Chapter The CHAPTER LIST
xiii	Introduction Preface Chapter Acknowledgments CHAPTER PART Part and List The Acknowledgements INTRODUCTION I of Foreword Abbreviations A About LIST Prologue
xiphoid	process cartilage and
xiv	and of Introduction The List in
xix	and Introduction Chapter PART of CHAPTER The Part
xj	is and are
xk	is and cup
xl	of and is
xm	in and is thick of to long for are diameter
xml	file data and
xn	and is are of the in
xo	is and
xp	is and
xq	is
xr	is and
xs	and is are
xt	and is are in to of
xterm	window
xu	and
xv	Introduction and of Chapter Preface The List PART CHAPTER Acknowledgments Part century in is
xvi	and of The Introduction
xvii	Introduction Chapter and PART CHAPTER Part Preface Acknowledgments The List of
xviii	and
xvith	century
xvth	century
xx	and is of to in xx The vi x
xxi	and Introduction of Chapter
xxii	and
xxiii	and Introduction
xxiv	and
xxv	and
xxvi	and
xxvii	and
xxx	xxx and is The
xxxx	xxxx
xxxxx	xxxxx
xxxxxx	xxxxxx
xxxxxxx	xxxxxxx
xxxxxxxx	xxxxxxxx
xxxxxxxxxx	xxxxxxxxxx
xy	plane is and
xylem	and of vessels sap is elements cells in parenchyma tissue to are or differentiation vessel strands water tissues
xylene	and cyanol is in or to for was are at isomers
xylol	and or balsam
xylophone	and
xylophones	and
xylose	and absorption isomerase is in to
xyphoid	process
xz	plane and
