Q	is and of in are to The for fever the waves as Q What wave can on be will I at A or with was has value values J a by R from Click How which that may output factor In must Do O If would point You And No o represents Is When were ratio units C water branch Did have To into resistor Quality does Yes had if D Why such i S being sort It we should Use Street when B CO material angle E increases Are This mismatch For Select P outputs Please Can Have ratios denotes per Figure but where Other through scan Now U could respectively methodology becomes cm c signals system it sorts then also test so Fever There Choose function matrix See over H My contains Does M We Queen All m As than between Microsoft s source An T represent given depends denote factors method column only Describe along Rev plot Where Type community Which versus Check statistic Fig On equals ceilings Make because tradition V equal e Who u But not load So curve At cycle N gives there stands branches n data lies Total After technique Open varies model under THE signal changes quality about due do using From moves after Explain Press x indicates Avoid defined register range reductase mismatching remains itself et band X Write r might Was acting With Using Add channel That an said did resistance form protein L times decreases Not means K saying Z channels Some
QA	and is program system to in activities
QAM	and modulation signal
QB	and is
QBE	grid
QC	circles and circle is Circle in program samples Circles procedures for
QCD	is and corrections calculations in predictions sum vacuum
QD	is and
QDRO	is
QDs	are in
QE	is
QED	and is Information
QFD	is process
QI	and
QJ	Med
QL	is and
QM	and is for
QOL	in is and of measures
QP	is and
QPSK	modulation and signal
QR	is decomposition factorization and algorithm
QRS	complex complexes duration axis loop vector and interval is morphology in voltage width deflection Complex forces tachycardia vectors wave amplitude configuration
QS	and is to
QSAR	models in and studies model analysis
QSST	election
QSub	election
QT	interval syndrome prolongation intervals dispersion and is
QTIP	trust election Trust
QTL	mapping analysis for in on is and
QTLs	for
QTc	interval prolongation
QUALIFICATION	OF
QUALIFICATIONS	OF FOR AND
QUALITATIVE	ANALYSIS RESEARCH AND
QUALITIES	OF AND
QUALITY	OF CONTROL AND ASSURANCE MANAGEMENT IN The IMPROVEMENT STANDARDS
QUANTIFICATION	OF
QUANTITATIVE	ANALYSIS METHODS AND
QUANTITIES	OF AND
QUANTITY	OF DISCOUNTS AND THEORY
QUANTUM	MECHANICS THEORY
QUARREL	WITH
QUARTER	OF SESSIONS
QUARTERLY	JOURNAL REVIEW
QUARTERS	OF
QUEEN	OF ELIZABETH VICTORIA ANNE MARY STREET AND CHARLOTTE MOTHER MARGARET CAROLINE
QUEENS	OF
QUEST	FOR OF
QUESTION	OF The AND IN What FOR I How MARK In A IS NO TO BOX
QUESTIONNAIRE	FOR The ON
QUESTIONS	AND FOR ON TO OF ABOUT The What IN In How A ANSWERED FROM Multiple I Write Circle True Answer ASKED For Chapter Directions THAT CHAPTER CONCERNING WITH As
QUEUE	node
QUEZON	CITY
QUICK	TIP REFERENCE REVIEW QUIZ CHECK AND FACTS
QUINCY	ADAMS
QUIT	command
QUITE	A
QUO	WARRANTO VADIS
QUOTATION	MARKS
QUOTATIONS	FROM
QUOTE	BRIEF
QUOTED	IN
QVC	Network
QW	lasers structures
QWERTY	keyboard
QWL	programs program
Qa	and is
Qaddafi	and was had has
Qadeer	Khan
Qadi	al of
Qadir	al and was Jilani
Qaeda	and in is was network operatives has members terrorist terrorists had or to fighters leaders as leader training organization attacks operative were forces cells would leadership are
Qaida	and
Qaidam	Basin
Qajar	dynasty period Iran
Qamar	al
Qandahar	and
Qantas	Airways and Empire
Qasim	and Khan al was Amin in had
Qasr	al Ibrim el
Qata	Window
Qatar	and is in has to was Saudi Petroleum National
Qattara	Depression
Qays	and
Qayyum	Khan
Qazi	of and Muhammad
Qc	is and
Qd	R
Qe	is
Qf	the a
Qi	and is Gong in to of stagnation are deficiency was or et can from
Qian	Qichen and Long et Zhongshu was
Qianlong	emperor Emperor reign period
Qiantang	River
Qiao	Shi Zhou Guanhua and
Qilian	Mountains
Qin	and dynasty Shi Dynasty Shihuang et was Shihuangdi emperor
Qing	dynasty Dynasty and government period court China dynasties was Empire officials empire emperor emperors state had rulers in Ming to imperial rule times Dynasties periods forces troops Court era
Qingdao	and
Qinghai	Province and province
Qinghua	University
Qinling	Mountains
Qiu	Jin et and
Qj	is and
Ql	and is to
Qm	is and
Qn	the is and
Qne	of
Qo	is
QoS	requirements parameters and is in guarantees for support management of routing control mechanisms to provisioning parameter constraints requirement levels class classes can level
Qod	and
Qom	and
Qp	is and
Qr	is
Qreat	Britain
Qs	is and are
Qt	is and
Qu	Yuan Qiubai and is
Qua	Iboe in de
Quabbin	Reservoir
Quack	and Doctor
Quackery	in
Quacks	and
Quad	Cities and City
Quade	and
Quaderni	di del della Storici storici
Quadi	and
Quadra	to and Island
Quadragesima	Anno
Quadragesimo	Anno anno
Quadrangle	Books of and Press
Quadrant	II I III IV of and Electrometer
Quadratic	Equations Programming Formula equations Equation Assignment Forms programming Functions
Quadrature	of Amplitude Phase
Quadratus	lumborum femoris and
Quadrennial	Defense
Quadriceps	femoris tendon
Quadripartite	Agreement
Quadros	and
Quadrupeds	of and
Quadruple	Alliance Treaty
Quadrupole	mass Mass
Quae	quidem cum omnia
Quaere	whether
Quaestio	de
Quaestiones	in super disputatae de Disputatae et
Quai	de des d Voltaire du Malaquais
Quaid	was and
Quail	and is in are
Quaint	and
Quake	III
Quaker	Oats and City meeting family who women in Meeting meetings State community faith school was of preacher woman Hill families lady poet movement merchant principles to friend minister or colony from schools influence friends parents tradition settlement doctrine Colonies stock missionaries had background is leaders girl leader party city Women beliefs merchants Road history dress William History named by missionary belief records Bridge religion Peace church group Graveyard preachers meetinghouse abolitionist John farmer Collection with ancestry worship road Church garb settlers ladies gentleman guns Philadelphia Education upbringing communities physician at philanthropist would sect parentage way Girl college pacifism heritage men as ministers Assembly
Quakerism	in and was is as to
Quakers	and in were had of to who are have from as was or for at did would on with that do is by could came also themselves the into believed should began made
Quaking	Aspen aspen
Qual	Life
Qualicum	Beach
Qualification	of for and Test to in as Requirements is
Qualifications	of for and in The requisite Authority to Framework are required
Qualified	Plans Domestic for to Retirement Teacher Plan Joint and privilege as Subchapter retirement students Domain plans Teachers Immunity Majority Terminable Pension immunity by residence
Qualify	for as
Qualifying	for Test the Examination widow as
Qualitative	Research research and Analysis Data analysis data methods Methods Chemical Inquiry Sociology Studies Health researchers studies evaluation Study Evaluation differences changes Methodology Reasoning inquiry Variables information aspects Characteristics Approaches Tests Aspects tests approaches assessment Approach or factors Assessment Changes observations Test
Qualitatively	the similar
Qualities	of and in are that which to such as for The or
Quality	of Control and Assurance Management control in is assurance Improvement Standards Act Award Circles management The Criteria improvement Assessment Progress System circles Planning Press Education Function Engineering or for Technology Index Circle to PB Review Inn as Systems Council Street was standards Monitoring has on Service Agreement Program can Protection at Is by Care Board assessment Manager Standard In Medical Indicators Evaluation Manual Data Quality factor Center Research Objectives Paperback Costs Level Information Model function Plan system Factor Initiative A Report Cost Policy Health Issues Time education time Requirements Measurement Analysis Institute planning with Division Guidelines Products Department systems costs Problems Characteristics must School Administration Class Of Network may Laboratory Audit Change Rating Chasm Books from requirements Software Factors Study Inventory Leadership that Counts Measures Office Congress will Forum Hill Models Performance Modeling criteria Enhancement Value Television I Awards problems Resources care First should versus Records Strategy circle Inns Improvements Foundation setting characteristics Services indicators Process are Indicator Engineer Programs Levels Uncertainty Bureau Parameters As issues Changes Digest factors Audits Tools
Qualla	Boundary
Quamvis	enim
Quan	and Doi Yin
Quanah	Parker
Quand	on le il je la les vous un nous elle tu ils
Quandary	of
Quando	il si la
Quandt	and
Quang	Tri Ngai Nam Trung Ninh Binh Duc and Tin
Quant	aux au a Biol il Cytol
Quanta	Cura
Quantico	and
Quantification	of and in is
Quantifiers	and in
Quantify	the
Quantifying	the
Quantiles	of
Quantitation	of and
Quantitative	Analysis analysis and Methods studies data Biology determination methods Study research assessment Data aspects evaluation Research Determination Approach Aspects measurements Studies Chemical measurement Applications estimation Estimation Approaches restrictions Criminology Economics analyses information Genetics Assessment estimates study Evaluation measures Restrictions Information Reasoning Risk trait changes results Structure Techniques comparison Comparison genetics structure differences Measurement International relationships History Method techniques determinations risk models PCR Clinical Models Description approaches Analyses Inorganic distribution evidence genetic Organic Measures comparisons EEG assay description or electron Trait Finance X Results tests relations Economic interpretation effects Untersuchungen Geography Assaying
Quantitatively	the
Quantities	of and in are for to which The that
Quantity	of and Theory Value in is Price demanded Unit discounts Quantity Demanded per Figure to supplied theory or Description Surveyor on Supplied Surveyors Total The Cost Surveying Discounts Symbol Variance for sold Item FIGURE produced In as Sold Name Discount A field production Amount Fig
Quantization	of and
Quantock	Hills
Quantrill	and was had
Quantum	Mechanics Theory Electron mechanics Electronics theory Physics Chemistry Chem Field of physics Optics Mechanical Gravity Electrodynamics Dots mechanical Leap Well efficiency Wells and yield Dot numbers Information Numbers Hall Efficiency dots electrodynamics meruit field Chromodynamics Computer Grav Yield number Number Chemical Computation Systems Logic Interference Cosmology ad yields Computing Fund Reality well Meruit mechanically effects dot Monte chemical Statistical Yields Healing Statistics chemistry
Quantz	and
Quapaw	Indians
Quarantine	and Station Act of Service regulations Regulations Speech is Officer in
Quare	Fellow non
Quaritch	Wales
Quark	and XPress
QuarkXPress	and
Quarks	and
Quarles	and was van
Quarr	Abbey
Quarrel	with between of and
Quarrels	with between and of over among in are
Quarries	and of in Act
Quarry	and in Hill Farm Bank Men at of Bay Road is was
Quarrying	and
Quart	J Livre of
Quarter	Sessions of and Master Horse Century in to was is Quarter Horses Session the Sales Deck for at or on Court ending Pounder with sessions past Ending Circle Ended as Moon Year had I were Masters ended from
Quartering	Act of
Quarterly	Review Journal of Weekly Meeting Bulletin and Report Press Conference for Almanac in Magazine Economic journal Meetings Progress Vol Reviews Newsletter Register magazine Reports Statement is was Reviewer Service vol review Historical Federal on reports Financial Court data by Publication Conferences article Econometric Sales meeting report or newsletter Digest Cumulative has Issue Supplement Publications Survey figures to I Data Summary Communication Record with Courts reviewer Statistical meetings The West publication Monograph no National that from as Earnings published
Quartermaster	General Corps Department of and Sergeant Depot in at Research to
Quarters	of and are in at for were to on
Quartet	in Books and for is of was no Op with on op by at to from has
Quartets	and in is of
Quartier	Latin de
Quartile	deviation Deviation
Quarto	of and text Edition is edition Shakespeare
Quartos	and
Quarts	of
Quartz	is and crystals crystal Crystal sand veins grains in Creek Hill diorite Crystals has occurs monzonite Mining Quartz
Quartzite	and is
Quasars	are
Quasi	in Contracts una
Quastel	and
Quaternary	Research deposits period Science sediments of ammonium geology and Geology Period age history time times Ammonium in climatic stratigraphy structure International Environments Studies volcanic sea vegetation glaciation glacial rocks alluvium History ice glaciations Ice marine climate alluvial Extinctions is environments Deposits Res formations or era Structure sedimentary
Quatre	Bras Saisons Vents Nations Gats
Quatrefages	and
Quatremere	de
Quattro	Pro Fontane Libri Coronati Cento libri
Quattrocento	and Florence
Quatuor	Coronati Coronatorum
Quay	and Street in was to of at is West on
Quayle	and was had said as in
Quds	al Al
Que	le la les de je se sais no es el si Corporation vous en ce voulez me Que tu Viva ne nous a Publishing sera Dieu Pasa Sera faire pasa los pour te tout diable son por and mon viva par
Quebec	and City in to was Act is government on as has had for by Conference the with were a would or from at are society that nationalism have Canada Province of Agreement will Gazette during where could Pension should which Liberal Bill into but conference than province Court who under nationalists provincial he Bridge city Resolutions Government referendum French et did after shall before state Ontario there may itself can independence until sovereignty economy must it National legislature separatism The politics law act when also since Superior Mercury Official governments might Seminary Civil became women Provincial Railway group Charter people Liberals Premier border within without Nordiques expedition alone they bill Street Ministry through premier nationalist population Federation against because libre over between side en about separatists I Quebec culture literature Department history only does voters scheme now political Task
Quebecois	and in government to
Quebecor	World
Quebrada	de del
Quechua	and language Indians in speakers is word or as
Queckenstedt	test
Queen	of Elizabeth Victoria Anne Mary and was Charlotte to had Mother in Street is Caroline Isabella Margaret Mab at herself would has Alexandra Christina for on Catherine City as that Marie with Regent Eleanor were Dowager Square Henrietta Esther Bess or by said who should could will the Adelaide Wilhelmina did Emma Maria from Isabel Bee a sent Philippa Jane came Ann Katherine gave Maud Hatshepsut Hortense took went Guinevere Louise made wrote might Katharine Consort Matilda Liliuokalani are Elisabeth can may must Latifah when died he County Joanna asked his Catharine Juliana Blanche received being told also then looked Cleopatra does s against I sat having Marguerite Guenever into Dido Louisa but so she Empress replied Pomare Joan her St Sophia never Salote which saw left mother Helen Helena not Vashti have The thought my now Sophie Nefertiti again Margherita Jezebel Min Charlottes upon during Maya found began returned street appeared became turned about arrived after visited knew shall Bertha Beatrix before Maeve than says Anna seemed still held refused Jeanne stood ordered entered spoke remained Gertrude wished felt Tiy o Elizabeths over hath nor called Of Juana Olga be heard Candace through Zenobia Noor only Claude Boadicea continued Edith passed showed if without takes there desired alone Kelly Draga whose answered an used wanted Mum opened put Luise Bees Ranavalona always Margrethe expressed thinks Constance Sirikit Annes Tiye Hotel whom once out kept smiled rose Frederika paid v it set wore Titania your Regnant Augusta Guenevere insisted all Mob very seems under granted Mine Margot declared because they commanded laughed lived Elinor goes Semiramis attended Jadwiga Mariana this gives Berengaria drove ofSheba Streets Eliza no Berenice mine comes Isabeau wishes brought appears Air Giovanna Christine more agreed immediately Ins appointed Creek decided issued too fell got lay Vic while Mothers Morgan walked Elena Kapiolani added retired rode first Is what Hecuba Dona our offered makes presented
Queene	of and is Elizabeth in was to as
Queenes	Majestie Majesties
Queenie	and was had
Queens	College of and County University in Road Borough to Boulevard are Park were Library Village is was have Museum county or who on with had Bench Expressway for as at that Hotel
Queensberry	rules and was had Rules House to
Queensboro	Bridge
Queensborough	Community Bridge
Queensbury	rules
Queensland	and Press in University Government to Museum is was coast Department government the has for had State as Art are border were National or from where by at Parliament with sugar on Law fruit Aborigines have South Institute Act Police of Parliamentary Premier a Branch that it during Agricultural there Labor Health
Queenston	Heights and
Queenstown	and to in on Heights
Queequeg	and
Queer	Theory Nation theory as Eye Politics Street Planet Studies Cinema and in how
Queering	the
Queipo	de
Quel	est che group que
Quelch	and
Quelea	quelea
Quelle	est der und des que and
Quellen	und zur des der zu
Quellenkunde	der
Quelles	sont
Quello	che
Quelque	chose
Quelques	aspects remarques observations reflexions problemes mots considerations notes
Quels	sont
Quem	quaeritis
Quemoy	and crisis
Quench	not the
Quenched	and Metals in from
Quenching	of and the in
Quene	of
Quentin	and Durward Skinner was Tarantino had Compson Bell is to in said Reynolds Prison Crisp prison de Matsys Massys for has on Blake Roosevelt Anderson Canal Fiore as could Lauer did at with would the Smith Metsys that
Quercus	robur alba rubra ilex spp sp petraea suber macrocarpa velutina and palustris agrifolia virginiana coccinea coccifera cerris borealis nigra prinus pubescens stellata chrysolepis species incana phellos
Querelle	des de
Queretaro	and in to
Queries	and on in for are to of with can The that about tab from
Querschnitt	durch
Query	with Language Analyzer Wizard Design Builder first and for Processing window by Designer or letters the to button dialog menu whether Query Manager Editor Results Optimization Languages OK Options in is command Type By Tools on from language languages processing letter The Window Properties as Datasheet Processor
Querying	the a
Quesada	and was had to
Quesnay	and was
Quesnel	and
Quest	for of and to in For is Books was
Queste	del
Questing	Beast
Question	of in and is by was to for Time the as What The Hour Concerning on Mark put I marks mark from Number about A How whether Answer de at Box In One that re Is number or with has which concerning Two Period Answering Type had Marks does II proposed Three box not a des If Do du time after Question Why your may will wording B being Types asked Jurisdiction Four one III before When would between Wording Presented No Book two can Of This him me no As
Questioned	by about as Documents on in Document
Questioni	di
Questioning	the of and is in by Techniques
Questionnaire	for and on The to Design was in is of Survey A data design Items responses Responses items Item survey Results Data as I were
Questionnaires	were and are can for The in to
Questions	of and for about to on in are that were About such concerning The like regarding have from should relating What as which Concerning can may with asked by In at arise I de Answered You A How the For or will remain raised arising related Asked That To Chapter must Relating Answers Regarding Question This Directions Questions also you involving a Raised sur Answer As put Series When arose Why We If Are pertaining Multiple There might These is Related Presented answered addressed often DIRECTIONS not would Do posed True Historiques It Circle Which could had Q CHAPTER Suggested Before between One Section without From Problems affecting still On Use
Questo	e
Quests	for
Quetelet	and index
Quetico	Provincial
Quetta	and in to was
Quetzalcoatl	and was is in had as
Queue	Length is and class Dual
Queueing	Systems Theory Networks theory Network
Queues	and are with
Queuing	theory Theory
Quevedo	and y was
Quezon	City and was to had in Avenue Ave Province
Qui	Nhon est a ne non de se tollis me cum autem in enim si vive Parle vero la sont facit va sait en fait le veut te plus vous quidem
Quia	Emptores vero non emptores in enim
Quiberon	Bay
Quiche	Maya and Lorraine
Quichua	language and
Quick	and Reference as to Launch Check Access Start Mask Fix Quiz ratio Review Response Guide Look View Test Tip Tag Tips in action reference Facts Ratio Tour now was Frozen march response or Select Answer Index Reaction work assets check Step Search Point Style Setup on with Assets Fox thinking Fixes C of is tip Render Report Checks quiz March Info Draw Service Steps List Format Change freezing Styles Time Print Job Action
QuickBooks	Pro displays to will is for automatically does
QuickDraw	GX
QuickStart	Guide
QuickTime	movie movies Player VR Pro and is Movie video for file files format player
Quicken	displays to will and for data can is Home Deluxe the
Quickening	of
Quicker	than and
Quickly	he she the I and they we now it as to a in remove
Quickness	of and
Quicksand	and
Quicksilver	Drive is Mining Messenger and
Quicunque	vult
Quid	est enim pro Pro ergo sit autem si de non igitur tibi
Quide	to
Quidi	Vidi
Quien	sabe Sabe es
Quiero	que
Quiescence	and
Quiet	Revolution on and American Man as Flows Time Life in Crisis Don Place down of now is Sun was One Hours time Room Enjoyment Woman the Days Hour Title Corner Zone City
Quietly	he and she the I they but
Quietness	and
Quigley	and was HA et had
Quijote	de and is y in
Quill	and was Gordon had
Quiller	Couch
Quilon	and
Quilt	Top and
Quilting	is Bee
Quilts	and
Quimby	and was had
Quin	and was et had etiam in
Quinault	and
Quincas	Borba
Quince	and at
Quincey	and was had is in has to says himself Morris as on wrote
Quinctilius	Varus
Quinctius	Flamininus Cincinnatus
Quincy	Adams and Wright Railroad Jones was to Market Street had in said granite of is on Troupe Whig for as Howe House has College with were Avenue Porter
Quine	and is has in does on says to would himself thesis was calls
Quinet	and
Quinidine	is and sulfate
Quinine	is and in was sulfate has sulphate
Quinlan	and case was
Quinn	and was had said et to is in of has asked could did would as looked for thought TC that took knew Mills on told Martin felt College nodded turned says went at the were with
Quinnipiac	College University
Quinolinic	acid
Quinones	and
Quinquagesima	Sunday
Quinquennial	Review
Quint	and was had said et
Quinta	de da do del
Quintana	Roo and
Quintero	Rivera and
Quintessence	of Publishing Int
Quintet	in for and of is
Quintilian	and says is in was had on has as to
Quintilius	Varus
Quintin	Hogg Hoare and Matsys
Quinto	Sol
Quinton	and was
Quintuple	Treaty Alliance
Quintus	Curtius Fabius Metellus Horatius Cicero Mucius and Caecilius was Fulvius had Hortensius Servilius Sertorius Cincinnatus Smyrnaeus Marcius Lutatius of Catulus Pompeius
Quip	for
Quips	and
Quire	of
Quirigua	and
Quirinal	Palace and Hill hill
Quirinius	was
Quirino	and was
Quirk	et and said
Quiroga	and was
Quiros	and
Quis	enim est custodiet non
Quiscalus	quiscula
Quisling	was and had
Quist	said and
Quit	India the your it command to that Rents Rent Kashmir and Smoking button worrying being from smoking Claim trying option rents
Quitclaim	Deed deed
Quite	a the often apart so simply right possibly recently obviously naturally clearly different true as frequently frankly early to an suddenly likely sure well aside in soon probably by generally unexpectedly literally rightly another honestly commonly unlike understandably evidently similar how good what independently all on impossible enough contrary close near otherwise properly simple why out correct like at common distinct some clear lately large possible logically small certain surprisingly certainly without alone unconsciously Contrary plainly easily appropriately correctly deliberately late similarly remarkable interesting remarkably ready important safe young interestingly natural independent from quickly unnecessary satisfied nice seriously definitely consistently warm conceivably reasonably wrong cold easy differently
Quitman	and was to County
Quito	and in to is was on with by for the
Quits	the
Quitting	the smoking Smoking this
Quivering	with
Quivira	Society and
Quixote	and is in de was of to had as with or has said himself that on by would at the who for did are a
Quiz	Answers Yourself Show on Questions Kids and for Book Bowl in
Quizzes	and
Quli	Khan Qutb
Qumran	community and Cave texts sect Community scrolls literature Scrolls in Texts was is writings documents caves text Literature manuscripts group sectarians Sect were
Quo	Vadis Warranto vadis warranto in facto and
Quoc	Dan Ngu
Quod	si autem non cum enim in quidem vero erat ad Deus est semper et
Quoddy	Head
Quonset	hut huts Point
Quorum	of Books to and sensing for
Quota	Act sampling of System system for Management and
Quotable	Quotes
Quotas	and for are were in on of
Quotation	from marks Marks is in of on and System Bureau taken
Quotations	from are in and of for on by
Quote	from is the on of in by
Quoted	in by from ibid on with and after as at here material In also
Quotes	from are and in on
Quoth	the he she
Quotidien	de
Quotient	of is and
Quotients	of
Quoting	from the a again an
Quousque	tandem
Quoy	and
Qur	an
Quraish	and were
Quran	and is in says was has as to or that which itself by are does for on with also were states
Quranic	verses verse schools injunctions text injunction law
Quraysh	and tribe were
Qureshi	and et
Quseir	al
Qutab	Minar
Qutb	Shah al Shahi Minar and was
Qutub	Shah Shahi
Qvil	War
Qwest	Communications
Qwilleran	said asked
Qx	and is
q	is and are The in the to of for as can be at A will from on a with What by or that has values may In which must How If r q To such was It if would represents being Do have I value o does we e increases per were denotes units There Is When when should then u An it For represent where Are times but denote into Use p i becomes implies wave respectively an given equal axis moving We You This As They between d over only se s through depends equals so x
qa	and is
qadi	of and
qc	is and
qd	for
qe	le les la vous
qf	the a his
qi	and is in of gong to stagnation vacuity are or as
qibla	wall
qid	for
ql	and Contact
qm	is
qn	the is
qr	is
qs	is and
qt	and is of
qtd	in
qu	il is and
qua	non being in the man e est de human individual a ratione re sunt ad et si object se Being individuals scientist nan ex subject parte per nihil women me rational nunc
quack	doctor medicines doctors and remedies grass medicine who of in or is remedy to nostrums
quackery	and of in is
quacking	of and
quacks	and who in of like are or to
quad	and is of in to flat
quadrangle	of and is was in with to are at maps the on which were map or
quadrangles	of and are
quadrangular	form in building space court and or shape area structure
quadrant	of and is pain in or to electrometer are with was for abdominal I as II the at III IV on tenderness that from mass by which may has where will A operation can contains into represents shows multiplier
quadrants	of are and in is to by with were or I as for on
quadraphonic	sound
quadrat	size is was method sampling
quadrate	and lobe bone with is in or
quadratic	equation form function equations in formula programming term forms terms and model functions approximation dependence polynomial expression loss trend or regression cost relationship utility assignment mean curve interpolation phase effect elements time convergence objective program factor residue component error surface variation discriminant fit effects performance with functional is relation response optimization factors polynomials components models differential for case residues law map Stark expressions criterion
quadratically	with on
quadrats	in were of are and
quadrature	of with components component axis phase amplitude formula and points to is rule detection formulas rules method
quadratures	of
quadratus	lumborum femoris plantae labii muscle and
quadric	surface surfaces
quadriceps	muscle femoris tendon and muscles extensor is strength mechanism exercises contraction are weakness group
quadrigemina	and are
quadrigeminal	plate bodies body cistern
quadrilateral	is with in are elements ABCD and of figure element space form whose or has formed
quadrilaterals	are and
quadrille	with was and of in
quadrilles	and
quadrillion	Btu
quadrillions	of
quadripartite	vault
quadriplegia	and
quadriplegic	patients patient
quadrivium	of
quadro	di della
quadruped	is of and with in or to that
quadrupedal	locomotion
quadrupeds	and of are in which that have were the or with to is as
quadruple	the alliance in of expansion its that bypass their meter and time point
quadrupled	in the between since to from its and by during their over
quadruples	the of
quadrupling	of the in
quadrupolar	interaction nuclei coupling
quadrupole	moment mass interaction splitting moments coupling and resonance field ion interactions splittings radiation is magnets transitions doublet transition deformation term instruments lenses lens
quadrupoles	and
quads	and of in are
quae	in est sunt ad non ex a de per supersunt ab nunc cum sit et quidem dicitur tamen sub omnia extant si pro mihi nobis nos pertinent inter etiam sint apud dicuntur vel fuit fit res sequuntur tibi vocatur facta sibi jam se supra secundum sola contra post fiunt me ante prius sine semper
quaedam	et in
quaerens	intellectum
quaestio	de
quaestor	in of and to
quaestors	were
quaff	the a it
quaffed	the a it
quaffing	the a
quagmire	of in and that
quagmires	of and
quai	de des du Voltaire
quail	and in before is or at are with eggs were to on hunting that for shooting from was as of under embryos
quailed	before at under and in beneath not
quailing	before
quails	and in before are were
quaint	and old little but in or way language to as town village customs humour humor conceits English shops style device charm words villages houses expression figures devices streets custom sayings figure story phrase name title notion idea conceit stories simplicity expressions manner appearance names costumes phraseology ways a description fashion picture place that than account wooden character fancy enough country design fishing mixture architecture inscription remarks characters ideas stone forms gables buildings
quaintance	with
quainted	with
quaintest	of and
quaintly	called and carved says expressed named put described said enough remarks puts observes dressed
quaintness	of and in
quake	and in with of at was to for that had before is as hit
quaked	with and in at as
quakes	and in of are
quaking	aspen with in and of bog aspens heart at grass earth
qual	se ity si cosa to i
qualche	cosa modo volta tempo
qualcosa	di che
quale	si non il e la era ha in per sono fu of io
quales	sunt
quali	si sono non la il
qualia	are and of sunt in
qualification	of for is to that in and was as or which requirements by on the required must should standards under at would has may tests from are test than will with can necessary process but testing he being shall level criteria levels does it shares were I had because if about upon when form be whatever a period system reasonably before could we rules here only not they requirement applies might except seems structure within such so
qualifications	of for and to are in as which were that required or necessary is on requisite have should may must than needed at will by would with can the he but was prescribed from they do set such had you I could being who we a mentioned about specified has it demanded so before might not be made shall include need under obtained when into rather solely through other did upon laid based framework listed within without essential regarding only if because above among imposed alone apply beyond also established possessed concerning stated
qualified	to for by as and in teachers personnel voters persons person majority plan than him people or retirement staff immunity medical candidates applicants the privilege electors plans under with individuals workers men students teacher individual women his them pension professional professionals employees experts sense candidate beneficiary this name himself property support stock voter members physician at on health man it acceptance domestic employee domain specialists her doctors doctor opinion manpower success their approval residence nurses but applicant scientists heir expert research engineers practitioner tuition according investment handicapped physicians only practitioners elector beneficiaries instructors one terminable small because young minority real use organization nurse legal a black business themselves labour officers higher joint that social right from employer trust disclaimer citizens engineer yes public technical me group status form charitable institutional is member faculty labor judges if of replacement foreign technicians witness non student are observers local education way through lawyer Negro researchers accountant instructor blacks names subchapter personal lawyers its negative pilot worker graduates dividends endorsement conservation scholars when class appraiser tax prospects Negroes so white officer expenses woman appraisal praise specialist interest organizations representatives accountants both he managers librarians job were indorsement low school female publicists family export representative veto educational leaders charity buyers pilots basis long work defined financial profit patient first you assent heirs human annuity intermediary franchise dividend mortgage rehabilitation teaching minorities before state path manner male therapist deferred attorney production either leads mental private electing will workforce independent observer African high securities service bidder investigators technician benefits jurors nonrecourse military judge surgeon may they librarian readers enough suppliers interpreters ACA statement scientific electrician should optimism officials resident jury psychiatrist not graduate income was disabled American cash investments witnesses management ones Subchapter preretirement adoption psychologist purchasers nursing us directors users payment fee child farm psychologists monism nor veterinary consultants veterans somewhat interpreter civil transportation title would terms citizen answer help even bidders shall buyer who assistant separate veterinarian object statements corporation clinical corporate version assistants team investors operator master certificate contractors architect nature these admiration distribution whites ministers operators recipients college majorities can attorneys leadership home firms purchaser my authority jobs authorities no consultant therapists physical housing
qualifiedly	privileged
qualifier	is of in to and for that
qualifiers	and are in to of that for such
qualifies	as for the this under them him his it a to and you her in that me us one or its an himself by all on
qualify	for as the them him under to a it this in and himself themselves his or their you by that her me an if on our us one its any at these your my because what with myself such only each men are all some even of those ourselves yourself within is herself students before either but
qualifying	for the as period examination event phrase words child them examinations under and adjective a conditions it clause word in him employer property exam or distributions himself phrases service income adjectives to person his widow terms term themselves exams clauses shares test statements children criteria statement individual date assets expenditure round asset factors rounds remarks age language condition their circumstances tests events distribution this of expenses an SPE company experience factor her individuals standards business that questions small requirements score relative real persons its courses time at information epithet organization facilities capital stock periods
qualis	est
qualisied	to
qualitative	and research data analysis differences change methods difference changes study or aspects information studies agreement researchers approach terms nature features factors results assessment description characteristics approaches improvement in as evaluation rather way character test distinction aspect evidence variables analyses interviews sense properties inquiry tests observations method picture understanding leap work behavior distinctions measures researcher reasoning criteria discussion methodology explanation improvements conclusions considerations one techniques comparison level variable descriptions transformation judgments content effects shift model composition interpretation manner case measure methodologies assessments dimensions dimension value point findings development examination statements values effect judgment similarity indicators models standards interview superiority than ones basis investigation predictions form determination arguments elements attributes theory growth knowledge to observation identification identity behaviour factor but material social state relations indication states comparisons variation experience side variations result relationships differentiation issues characters evaluations measurement perspective risk estimate structure platelet relationship field performance characteristic design questions simulation statement argument significance market requirements estimates detection interviewing survey responses physics element chemical shifts conclusion meaning impact judgements versus idea measurements process traits insight categories concept relation fashion representation response alteration component insights view pattern concepts scale feature trends phase review control investigations spatial transformations parameters edge definition increase judgement similarities alterations paradigm prediction goals classification forms experiments indices account problems estimation jump importance forecasting restrictions benefits reactions determinations objectives procedures diversity abnormalities property purposes correlation standpoint criterion leaps break type standard arms advantage technique consideration comparative progress treatment materials comments ideas decision levels
qualitatively	different and similar the new distinct in from by as identical with or correct to superior better consistent for more very that explained higher understood described but a at changed how indistinguishable unique on determined inferior like quite change differentiated altered what good
qualite	de des
qualitie	of
qualities	of and which that in are as to were or for is he such have with can they we by may the necessary required from than will you needed I would but it like on do was not at associated had into must should so she a most make could inherent when essential more within without made attributed being possessed rather might also has found requisite only through did mentioned alone about one both be does appear seem upon exist among themselves desired belonging common because become demanded there ascribed come other peculiar under include if often even displayed all characteristic listed depend similar described belong usually too already before combined developed above desirable while considered very just together over sought his an give besides became expected generally present whose called beyond during came except remain perceived now between seemed according far no nor this related exhibited proper who here out given known go still thus involved shown inhere derived produced either quite tend gave these constitute never then expressed shared always against emerge need brought represented rarely traditionally appropriate after lacking much onto stand making each enumerated existing render worthy enabled vary best valued included superior their commonly help until shall fitted well important deemed united led different
qualitv	of
quality	of and in control is that to or assurance which as standards management improvement for was than are products can by at from with education has care may product will problems time about on but work system circles service level factor data assessment requirements were criteria goods the when information services standard should would characteristics levels health issues paper he must it rather monitoring improvements have because food performance programs through they so we not objectives between protein parameters factors into could program water indicators systems materials research had I within changes over attributes measures costs images controls if circle index you production housing characteristic without does results child differences goals image a video problem being evaluation during material required planning also among merchandise steel depends sound policy output medical model only training land teaching more be specifications software patient throughout audio function might cost due measurement models such while books illustrations change varies rating called educational process plan under public seed even after analysis inherent ratings movement wines instruction deterioration learning The measure before loss tools she studies coal aspects people like wine measurements becomes manual makes seeds most items who printing films one decisions review all fruit audit equipment life color manager often nursing variables degradation inspection schools raw foods associated based initiatives professional alone improved since investment engineering white day checks audits printer means conditions components black nor staff literature made dimensions there relationships seems testing enhancement indicator common programming considerations according environment comes decision metrics papers ingredients concerns tests digital both oil good design issue known compared remains itself found reproduction produced necessary hay teachers early guidelines records construction did criterion possessed meat upon needed used wood timber furniture very outcomes leadership appears personnel check cotton television improves available regulations milk department soever do print workmanship protection solutions music requires features energy attribute grades produce customer relationship impacts too job high photographs assessments traits rice pictures using indices approach class related score competition here processes versus desired culture bonds certification school press classes graphics editions jobs glass concrete forage fish modeling wool across content development increases grade children test maintenance above effects targets equal beef values resources parameter parts plans writing efforts printers cars scores art much setting comparable prints where stock demanded initiative usually iron needs regulation effort requirement demands still leather dimension possible speech deteriorates activities became settings cloth no coffee film A benefits first variations proteins experience points commercial difference generally clothing picture defects managers until now employees scale exists group similar team lies feed principles include programmes beyond strategy newspapers expectations resulting reports fabrics objective came elements human diet against samples adjusted achieved computer except local teams goes essential variation recording suitable support crystals range consumer this units end voice belonging procedures single conscious gives space up quite evidence organization treatment practices adjustment variable engineer report family study sleep natural legal concepts ones healthcare provided growth point peculiar out obtained business professionals line per value home labor along given almost workers documents sites fuel consciousness stocks childcare awareness refers far practice technical controlled council surface soil pieces fiction copies always text wheat instruments shall shows policies programme agricultural stone thereof whose grain optical tea awards expressed works then eggs metric living tends preschool tape red In survey impact set shared projects schooling leads higher award market an corporate limit stuff communication inputs experts entertainment companies specification habitat better engineers men attributed concept revolution recordings trade goal institutions steels differentials superior decreases social candidates science suffers caused reviews low fresh building described just brand primary plants academic basis matters aspect whatever students articles car either long finish instead never reproductions trees mark silk affects feedback unless gap bond magazines classification shoes x clinical paint animals paperback occurs fruits declines tobacco publications relative clothes trends evaluations project varied losses signal documentation type constraints belongs depending teacher private judgments metal methods perception reputation implementation newspaper seemed gas remained ot hard book field need salt solution code effluent advantage properties assured offered olive categories involves assets status infrastructure facilities journalism expected framework diamonds vary firms present basic physical accommodation stereo productions these American environmental Q curriculum went result spectra soils his sampling brands component grass colour considered philosophy photos applications air scientific textiles roughage limits modelling ore TV source players indexes approaches radiographs new well lines light imported ratio machine grading risk what focus sometimes make printed functions residential though laser ideas houses fabric takes deteriorated groups welds large specified analyses craftsmanship inspectors controller perceived photographic news oflife falls company employment financial silage different measured rubber provision experiences less manufacturing unit pasture lacking inferior power industrial leaders leader adjustments declined whatsoever animal foreign lumber marks lenses tool restaurants grapes having perceptions terms office instructional legislation began determination begins item surveys rock sources fuels inspections ranking firm supervision below drinking bread obtainable hotels characters strategies piece advantages consists directly oils input varieties profile techniques perspective ranges homes thus transmission faculty derived workforce reporting reference areas camera maps electronic flint ascribed become already suggests rules record implies especially crops library sufficient gurus come includes student show copy really threshold mode effect q Figure category rarely paperbacks producers responses table world urban spectrum community distribution appropriate brought X other imaging English media flour magazine independent target checking producer Web diamond labour monitor decline securities simulation performances cuts domestic questions estimation norms folks increased dry prediction tourism best attached indicated technology laboratory rare hand controllers represented led garments reading continues interaction epitaxial including cattle drugs network plastic thinking DNA chocolate around yarn manpower indeed plant
qualm	of or about
qualms	about of in and at as that or over were to on when with
quam	in ut si ad de quod ex non per a cum pro ipse qui sit primum ab etiam et maxime quae habet nos ego nunc tu sibi est diu Deus pereat ob ipsa tibi te ille multa quidem se res omnes mihi extra bonum prius alii bene
quamdiu	se
quamvis	non in
quan	tity ly
quand	il on je ils le elle la les nous vous meme elles tu un une ce
quandaries	of and that
quandary	of as about in is for over that and was when by to
quando	si la il non se in a le lo i o e est el per
quangos	and
quanity	of
quant	a aux au il
quanta	of are in and per is absorbed or with to emitted which that from can by as at released
quantal	release response content
quantifiable	and data in terms measures results factors benefits variables information aspects or measure objectives
quantification	of and is in over theory by can are to was as or for into with has that methods may method using
quantificational	logic force
quantifications	of
quantified	by in and the as using with for variables or to data at on over modal sentences through variable from statements sentence noun NP expressions statement expression formula NPs but information into
quantifier	is in and scope to phrase of phrases elimination can that
quantifiers	and in are is of to can as that such like over which
quantifies	the over
quantify	the and this these their in a over it how them or such its what all that some because but of than changes any with precisely an our both as his risk your those
quantifying	the and over these a this their them
quantile	of plot regression function
quantiles	of
quantisation	of
quantitate	the
quantitated	by in using as with and
quantitating	the
quantitation	of is and in by
quantitative	analysis and data methods restrictions information research terms determination study measure studies results measures measurements measurement differences or evaluation approach assessment aspects description analyses estimation techniques method changes estimates comparison trait relations relationship evidence work relationships approaches estimate basis difference in traits relation models agreement importance way change expression model aspect theory values variables determinations treatment comparisons risk test rather predictions nature interpretation indicators manner increase sense value genetics criteria growth as characteristics form characters significance factors tests understanding expansion effects one effect structure investigation variable reasoning assay import variation skills genetic distribution character survey PCR composition controls point assessments limits experiments knowledge restriction chemical yield review targets but variations statement standards definition findings statements methodology index researchers prediction calculations technique parameters procedures laws scale performance properties tools separation science investigations concepts impact indices descriptions economic observations ones features development level analytical examination factor accuracy fashion content control conclusions recovery characterization thinking correlation dimensions considerations dimension than social methodologies evaluations explanation requirements goals problems verse calculation picture precipitation to precision side discussion criterion representation result reduction estimations means assays RT concept limitations procedure scores inheritance meaning modeling expressions surveys electron problem details purposes formulation system material history coronary detection computed revolution application elements experimental ability conversion use EEG ratio view synthesis response tool indicator questions element empirical phase attributes framework characteristic decision testing answers yields perspective limit applications trade by culture standard indication superiority contribution account extraction distinction de standpoint process score proportions sampling objectives facts law limitation statistical autoradiography detail production image solution levels forecasting answer support output literacy real versus part improvement modelling economics design parts classification scales appraisal extension increases figures distinctions theories precipitin time samples judgments scoring for idea units X observation implications regulation experiment summary balance theoretical management easing role correlations paradigm chemistry physical cultures equivalence reaction question amount geography resistance researcher outcomes consideration is influence transfer des component with fit responses forms verification mathematical conception alterations flow autoradiographic ratios proportion sensory imaging morphology rules requirement magnitude proof record forecasts credit conditions
quantitatively	the and by in to with different as from determined or important for measured more but significant similar into measure related analyzed described oriented less evaluated expressed describe assess at on determine assessed evaluate measurable small converted precipitated defined transferred estimated using how accurate is a that correct greater most very compared speaking much insignificant measuring it removed equal reduced unimportant inherited compare recovered analyze based of minor studied estimate
quantite	de
quantites	of
quantitie	of
quantities	of are in and to for that as at which by from is were can on than or may have with such will involved sufficient the used required into must being only produced a demanded it should they during would needed we was but so when given over not like sold consumed available without A supplied under has could measured purchased within through x per associated because be do had vary up if greater defined less necessary throughout shown whose until between obtained before related along depend after appearing large exported also above taken p too found imported represented having all themselves he exceeding where listed varying using The upon determined you expressed near derived rather equal actually corresponding calculated according might called ordered X entering specified indicated since present received remain both appear directly characterizing every refer bought mentioned together more change ranging each among represent concerned even there depending far usually I E except shipped P become offered just about compared n here occurring e proportional increase relating describing r include u thus while based m below already does v desired need traded one considered known other delivered introduced T beyond Q exchanged q gives made now employed thereof then often around contained shall
quantitites	of
quantitv	of
quantity	of and is in to demanded or that which for supplied as theory was at by discounts than on from can will produced may with required has sold the are production but being would used must a should consumed it sufficient into called purchased per we A Q discount they surveyor rather only be taken so when available he not equal needed ordered x index exported increases under over necessary measured could imported given variance had were does such changes if whose within during present without varies I you obtained surveyors where q bought p actually offered known depends data y equation e because X might received between contained desired shipped having alone thus before depending n defined found thereof purchases represented The made proportional nor until more less discharged E delivered also through S represents exchanged r remains k involved corresponding P after becomes brought F determined have surveying theorists m R there control orders usually B according itself greater traded V allowed C remaining v upon specified raised added combination change T since K c t M expressed about associated shall h like employed both D absorbed restrictions H divided adjustments f adjustment one above now each generators decreases b increased either falls then even model d related multiplied variances u constraints L compared passing standards annually applied every s indexes sent time axis flowing terms appears g too buying lost weights N calculated up term here varying passed rationing equations left system gives requirements representing price exceeds measures ot manufactured due injected In while limits stored equivalent controls versus W i G times Z throughout carried information basis just directly along indicated combinations z relationship shown inside makes excreted indices prices sought equals wanted survey w already issued based beyond o among independent U still exceeding factor did variables goes instead seems estimated administered relationships introduced generator plotted always increase collected she J often rises demand stated this derived secreted all sales out against removed using space rates whatever prescribed value effects held Y competition effect provided output
quantization	of noise error is and levels in step axis errors condition level process for effects scheme to rule can procedure with
quantize	the
quantized	in and energy to into values with by states field Hall signal value levels
quantizer	is with and
quantizing	the noise error
quanto	riguarda a si magis la il non in e al di concerne per sia
quantum	mechanics theory of number numbers mechanical physics yield efficiency well field state states leap dots wells meruit electrodynamics ad dot effects and gravity system yields jump systems chemistry is level in fluctuations computer phenomena chemical energy world information leaps logic interference computing Hall confinement computation jumps statistics mechanically coherence wires noise efficiencies chromodynamics hypothesis theories or computers optics wire nature est potential conditions measurement dynamics physicists condition limit particles fields statistical cosmology size corrections defect transitions levels tunneling particle effect processes to electronics cryptography description wave objects transition events properties vacuum reality beats phase theoretical chaos laws model flux entanglement uncertainty physicist cascade change case evolution fluctuation object domain process gates Monte requirement teleportation sufficit rules phenomenon calculations communication transport formalism structures principle algorithms correction per error revolution has superposition behavior for was spin treatment indeterminacy confined energies can as beat probability correlations critical mottle algorithm fieri structure concept group coherences key defects postulate ideas point channel non with which measurements oscillations concepts physical event theorists universe absorbed increase potest principles version devices circuit regime hv mutatus that index will
quaque	hora
quarante	ans
quarantinable	diseases
quarantine	and regulations of station for laws in was measures is at on the or stations period against to officer restrictions procedures area as ground line system law officers by service until speech had camp would has treatment requirements facilities are flag with hospital
quarantined	for in and from the at
quarantines	and
quarantining	of the
quare	clausum impedit non
quark	and model mass masses is matter in or has production confinement fields pair with distributions theory structure models distribution states to flavors of
quarks	and are in is have to of with can or that as were together
quarrel	with between over and was about of in is which among that had or to on at arose as for by broke against ensued the would he has when upon took so began they a might I from were not will just amongst but should may before became again now could because than if we scene can without within came like into there betwixt ended are occurred here grew it she more must did developed soon concerning went out continued be all arises after arising any only having ensues being
quarreled	with over and about among bitterly in violently so for
quarreling	with and over among about in between or of is for factions
quarrelled	with over and about among in violently for bitterly at so on as amongst
quarrelling	with and about over among in for or between amongst as of at on
quarrels	with and of between among in over which were that are about or to had as at on within arose by for have broke would amongst was the is will they arise he from than may arising can should might
quarrelsome	and disposition or man nature in people as with temper than fellow person
quarrelsomeness	and of
quarried	in from for and at stone on out by near the to away rock
quarries	of and in are at were near on to for have or which from that is where the with was as by had
quarry	and of in is was at to for on near from or had with the that has face which where stone by as tile workers sites site tiles a floor would are were into out he work will it before stones operations about there when may owners area rock pits owner wall
quarrying	and of operations in the stone is or for was industry Manufacturing activities
quarrymen	and
quart	of saucepan casserole bottle or and pot jar bottles water de for baking milk to jars in measure glass a is pan bowl size container per du capacity can at souffle microwave Dutch cans heavy mold pail containers
quarta	parte
quartan	fever ague malaria parasite fevers
quarter	of to century and in or sessions the mile past was for is million from inch as section where that before were on note hour after inches hours at turn by notes with are a it miles had deck which moon would ending will length per view they sections wave wavelength circle when has he whence part pound millions I ended into horse years full we than have should there during acre day so long pounds point period but times system round each earnings more days tones share horses given points if may being cup interest an cycle ago billion cents between time sales only could profile less can since panel master came you year dollar page called his dollars convention over them acres centuries this tone under later without size results until must ounce face back moving did near also out shall against upon their because crown columns till session wide now its through square quarter line within following panels who speed might themselves circles rest revolution teaspoon one corner turns ton around fighting way t known said she all alone credits be above minutes while ounces course about load phase towards rations just basis off troops column feet court chord percent up last below broad whatever grain tons not gallery distance left down boat beginning second report then began eagle asked inhabited mark do loss every scale went profits strength apiece south The plate too views occupied north units him
quarterback	and in for who of to is on was at with has or Joe from sneak can had
quarterbacks	in and
quartercentury	of
quarterdeck	and of to with
quartered	in at on with there and upon the for by here his themselves near as oak among a them within or lengthwise himself to about
quartering	of the large troops and soldiers in his a them
quarterings	of
quarterlies	and
quarterly	and basis journal reports meeting or data by newsletter report meetings magazine payments in publication to review earnings dividend for financial sales installments payment returns on of with conference instalments at dividends statements return figures period reviews bulletin issues intervals series tax from results average published statement estimated income allowance accounts as periodical interest estimates is rate reporting periods since updates cash model issue averages Journal progress observations survey time performance values profits index changes profit account journals compounding conferences supplements installment Bulletin publications sessions that court which
quartermaster	general of and in at to sergeant was for corps had on department who stores with
quartermasters	and
quartern	loaf of loaves
quarternary	ammonium
quarters	of in and for at to were with that on are as the or where by was from is there which had a it full have into he when than would during they near after before about I without will but until here should within we under so being over per above may while has provided because could inches can this occupied against if assigned must behind through long more all between came not upon below only an among now outside out around one like since majority also again even past became she did along up elsewhere be just such might still today too view built made till you who filled length across down ending each his upstairs next every towards immediately consisted inside instead inch empty together shall aboard round do rather wide set ahead very miles available back some prepared close later off both once throughout
quartet	of and in is was with for that to or from by as at which had playing singing has on played are were music
quartets	and of in are were for by to with that is
quartette	of
quartic	equation
quartier	de of
quartiers	de
quartile	of deviation is and range in for on values or
quartiles	of and are for in
quarto	volumes volume of edition pages and in size editions form pamphlet die was is or text sheet with paper de page sheets Bible format
quartos	of and were
quarts	of water per and a in to or for de cold boiling daily are at
quartz	and grains veins is crystal sand crystals in or tube monzonite diorite are with pebbles plate rock vein of was glass from porphyry to sandstone has which particles as window at mining fiber content that plates wedge reefs mercury lamp schist tubes grain were sands may by for mines cell rod fibre on fragments can rocks windows spectrograph phenocrysts lenses sandstones lens substrate have mill prism oscillator lodes cement diorites the veinlets occurs arenite surface gravel latite overgrowths syenite mills inclusions containing porphyries fibers pebble will cuvette arenites reef powder gangue schists lamps clock watch but cementation dust stringers watches substrates into flakes being halogen mine conglomerate envelope silt capillary rods cells crucible resonator occur would stones had also vessel
quartzite	and is of in pebbles with or are which beds from at was
quartzites	and of are in with
quartzitic	sandstone sandstones
quartzose	sandstone sand sandstones and rocks
quarum	una
quas	in ad non
quasar	is
quasars	are and with in have were is at
quash	the a or an it any service all and this
quashed	the by on and in for or a because as it
quashing	the of a
quasi	in ex contract public judicial per a rents non steady una ad sempre rent tutti de contracts un two war one corporations static
quasielastic	scattering
quasiexperimental	designs design
quasiparticle	states
quasiparticles	in
quate	to
quatenus	ad
quaternary	ammonium structure system nitrogen structures carbon compounds amine salts amines and alloys period salt systems compound deposits alloy
quaternion	of is
quaternions	and
quatorze	ans
quatrain	of is in and to which that with from by on was
quatrains	of and in are with that
quatre	ans heures ou fois mois jours parties cents mille cent premiers vingt autres
quatrefoil	in
quatrefoils	and in
quattro	libri
quatuor	libros
quaver	in of and
quavered	the and as with
quavering	voice with and
quavers	in and of
quavery	voice
quay	and at of to in wall was or is with walls where on for by the as were which from that a side cranes
quays	and of were are in at to on or along for with
quayside	and at to in
qubit	is
qubits	are in
quc	e
qud	non
que	la le les se je nous no el de vous ce en los dans des es a par pour me cette si son ces las nos tu lo l trust por celle yo ha celui tout ceux era sur o leur sa cela tous han su con te un tiene esta lui ya Ton Dieu ses celles os soit al una hay sea para du possible fue cet mon este toutes ne non todos tienen toute leurs notre nunca il todo puede jamais ie deux est use moi hace votre ellos ma vos he chez estaba comme ella va sus in as quelques rien chaque mi cada hizo fueron plus sean pueden Dios haya personne chacun d eran certains ni mes como bien quand debe tengan siempre pueda sont mas peut hoy hacer depuis tenia hayan da lorsque cuando hasta ahora habia antes ser soient faire esto usted ver estos quiere sous trop tanto sunt van tengo parece peu viene hemos entre nadie plusieurs desde existe estaban estas puedan sin hacen li eu uno soy tenga fait pasa certaines llaman j deben estan nosotros dice tal todas ad tuvo contiene aunque pendant nada trois nul ele nao solo sans vive is sera beaucoup del iba Monsieur mal e fuera tan doit em viven lleva tant and tenemos permite sabe tem fuese parce aun toda luego algunos fuere lhe tel dit sobre Je representa on estoy estamos I aqui existen Sa luy quelque trata sigue significa otros telle muchos tenian vie pudiera hicieron per foi dicho dan esa ese ton font aparece forman presenta ca somos ay durante corresponde despues mis dicen vienen Ud figura asi habla ir aparecen dio vers fut aquel resulta lors sirve trustent voulez apenas lea queda agora parmi Jean consiste celuy has et toca haga ta fuit seria avia tambien havia La donne podemos casi mejor iban entonces otro nuestro muchas decir respecta nostre tener constituyen vino eso deseen cualquier ninguno habian tres elle quando ledit peuvent quieren um tratan nuestra produce otra Vous Von selon venga quiero ela na so figuran actualmente llega aquella ofrece eres forma ninguna que parecen toi llevan estava trabajan coute alli une hubo to representan ocurre trusts incluye llevaba dos pudo moy tuvieron fa Votre hubiera constituye fueren nace dentro sirven permiten vostre alguien voy pudieran otras rarement siguen hablan c estar Juan quatre seule aquellos ellas s sale pose mais seja algunas Le afectan chacune uma ceci fit dicha fuesen Madame ceste seul constitue pasan comprende presentan corre y ja contienen indica doivent Pierre souvent nuestros V posee deja posean puedo muestra tienes devant anda digo vaya realmente dicitur dire hacia busca contre qui siendo parecia tales Marie vamos pode pagar A ambos pertenecen llegaron dieron don bon cuenta pourrait permita dar algo conduce causa trabaja jamas partout quiera permitan llegan vi dizen pourra trae vayan solamente usan acaba parte veut recibe quedan alii saben tes corresponden nulle necesita vocatur establece voici llegue Vuestra pertenece com implica mientras vient
queant	laxis
queasiness	in
queasy	feeling stomach and about at
quebecois	de
quebracho	extract
queda	por en
queen	of and was to in had is Elizabeth mother who Mary with herself or at Anne for would as bee has on that were from by should cells will could dowager regent the said did a gave may might are can died took sent consort made came his went must when she among also he bees into but cell then whose being does asked Margaret bed than her having so it now Isabella beds received became rearing upon before over excluder I Catherine saw lays which looked after replied not sat substance against named again have be told without mothers called Eleanor found city during thought whom never shall regnant appeared still turned ordered Henrietta wrote if remained my size began ant only left Catharine heard about Katharine knew Caroline entered out seemed returned stood there alone refused takes because continued nor here answered immediately fell soon appears while held conch through Philippa like arrived put rose felt posts post spoke they under brought wished you gives Jane hath lived an seems more all dies Victoria set larvae Cleopatra passed instead goes commanded too smiled once comes kept no wanted lay says until ever
queene	of
queened	it
queening	it
queenless	colony
queenly	dignity and woman
queens	and of in are were who to have or on from had with that as is at problem for will can may was by would do which should
queer	little and theory thing old things to way feeling about sort people in that as look kind fellow studies mixture one place fish or the politics theorists ways ideas sensation world looking name for smile story lot man how community is sense notions youth business identity stories it expression places culture enough but idea a characters when creature life at creatures names girl figure if character combination sound reading men noises notion state voice experience bird shapes desire chap communities sexuality country noise light part ones sight was small women I taste folk identities tricks space you indeed because with person time fashion of duck smell animal movement
queered	the
queerer	than
queerest	thing of
queering	of the
queerly	at shaped enough and
queerness	of and in is
queers	and in are
quegli	anni
quei	che
quel	che point que est tempo momento di giorno modo
quelconque	de des
quell	the a it any his her an them this their disturbances all these riots my and that some such
quella	di che del della parte dei delle
quelle	est que che mesure di heure del cose a
quelled	the by a and in with it his her only all without them at
quelles	sont que
quelli	che di del della
quelling	the of a look an it
quello	che di della del dei delle
quells	the
quelque	chose sorte temps peu part autre fois jour tems lieu maniere
quelquefois	de
quelques	formulaires jours autres uns mois mots exemples points annees cas aspects heures remarques unes semaines lignes minutes observations problemes questions instants centaines especes personnes dizaines pages traits endroits
quels	sont que
quem	for of in non ad is
quemadmodum	in et
quence	of
quences	of for
quench	the his their it my our your all thirst a her and its in that this love them is to or correction fire not tank from rate one of any
quenched	in by the and from with his to their at it samples my for or into end her as our steel specimens sample when after state all on alloys alloy its spark condition
quencher	of
quenches	the thirst his all
quenching	of the and in is from by rate temperature process to effect medium his it their or with thirst a at was experiments agent rates can bath processes effects distance method are gas media on cross mechanism
quenchless	fire
quency	of
quene	of
quent	to
quently	the in to used
quercetin	and
quercitron	bark
querelle	des de
queried	the about by in whether as with for on and a him to his her this one at from why
queries	and to are in that about on of the from by for can with as were is or which against will using over may regarding have concerning into such at a you should whether based involving would put was we I must like raised made sent per without through could he only do when it within posed
quern	for of in is and non
querns	and
querulous	and voice tone old note complaints
querulousness	of
query	is to and the language in that letter as processing results of for about string with by languages from on or can was will whether a optimization result using execution has are optimizer sequence may would into terms which returns plan design performance letters against evaluation Q you image window processor at formulation expansion should time object term system must expression point answering it q response data does if based form set tree could interface might concerning such name statement graph without table tools type regarding tool first plans uses message we strings this grid I over like types engine contains R an process when criteria so shown expressions where operations operators parameters datasheet why had before output vector rewrite definition only retrieves itself information syntax systems specification capabilities but them he again box modification used shows operation translation A requires file how after their arises messages what pattern facility model because statements all through structure came SELECT facilities your its
querying	the and of a for whether
ques	tion tions
quest	for of to is and in was that as after by has which with or had he on will would into the ion may at through can are itself from narrative must a I but motif led order began story romance than toward not ions were we when takes they becomes should leads begins Of
questa	parte e volta mia cosa vita
queste	cose due parole ultime
quested	to for
questi	ultimi due
questing	for spirit and mind after fingers
question	of is was that whether the in to as and about which for has arises at by on with may or can had will would are remains we I mark from now then must here before were but should concerning how he asked arose it raised a you what why might could his him if being posed their not does when becomes regarding be this put her because came still concerns between have under marks presented its than so again naturally without seems one more did upon them they involved like comes shall me she de there itself into only after such also therefore remained my depends asks became thus requires any often our all first until your arising involves where who lies relating seemed over relates addressed open some immediately directly since appears during an even really among out very respecting just made once asking rather no within through either too always facing left these further both many proposed involving related needs answered form most took number presents discussed do concerned correctly having every brought today see turns carefully submitted leads types period ought referred wording suggests much above What time jurisdiction whatever makes refers simply seriously against each occurs never back later unanswered everything while des du below altogether been whose affecting takes himself God frequently implies yet goes ever merely remaining those already settled clearly word need up occurred unless using right type usually exists entirely appeared beyond relative forms raises set shows except answering contains connected belongs based aside led means actually calls alone two brings worth propounded words assumes doctrine gives went began fully around format The gave nor inevitably quite arise deals almost requiring myself recurs provides authority used suggested next turned stem differently us emerges properly considered sometimes deserves however caught consists confronting follows three another lay according people papers applies stands several fairly decided affirmatively received touching generally stated given contained well indicates themselves A How indeed est resolves surprised pertaining required hung traditional anything Why throughout till obviously other demands startled Is continued followed dealt probably caused instead soon rests witnesses falls satisfactorily seem let yourself finally hour begins paper behind somewhat long reveals answers returns belonged implied underlying come cases meant focuses rises represents addresses thoroughly completely formation necessarily begging better provided along reads showed said certain pertains coming qui designed twice included whatsoever kept directed difficult appear exactly rose down sounded read debated allows certainly presupposes poses continues everyone worthy admits aloud specifically proved gets taken assumed things test numbers bears Who uppermost order includes passed precisely Jesus dealing include ourselves quickly closely assumptions points helps forces found formats though In produced persists fell box squarely mentioned constitutes His off reflects pending perhaps formed relevant faced tests hinges herself called depended following honestly indicated sets que solely make earlier anyone constantly says away struck runs depending determines tends similar due far stood consisted together emerged certified last touches four held belong become established hardly outside existed existing affects determined anyway opens repeatedly revolves wrong carries briefly examined definitely less seeks suddenly serves ultimately stems apparently ot hanging se regards states dans anew deeply neither purely forced explicitly revealed intonation particle looks undecided resolved needed sounds show adequately best previously amounts repeated touched occupied prior something go tells i et prompted receives sent juive reached carried agitated negatively happens blank per necessary easily calling largely argued formulated incorrectly important offers centers got varies forever conventional central five constituted remain grew entered originally primarily recently early started demanded elicited boils marker design reduces sequence thee separately changes particularly sheet illustrates definitively bearing mainly list focused differs whenever provoked hangs items invites accepted especially although depend d drew likely argument apart lie written represented clear results evidently question amongst treated technique demanding holds moved cf implicit plainly opened en cards positively happened resulted unsettled l whence sociale threw practically reminds intended ran mean forward sought finds begs someone placed puts point students occur old expressed nearly others changed basic straight confronts accordingly played truthfully keeps meets invariably commonly reserved nevertheless loomed Him relate proves looms aroused uses haunted sound popped analysis tags rested survey formulation elsewhere take affected surrounding hit offered home fall re applied plus contain impossible beginning answer stopped exclusively leaves openly essentially failed produces merits la introduced troubled ne met present refer par text presses broke give toward echoed method fails John indicate o hang involve head possesses puzzled continually created bank Where causes sufficiently stand content differ pertinent subject fundamental otherwise B corresponds derives expresses accurately represent women rest He presently suggest served reflected undoubtedly constitute explored hard covers divided introduces indirectly referring starts publicly periods prompts orders lead Q unresolved shortly responses allowed whom across Do true logically surely developed associated require rightly occupies afresh When common approach six looked originated vary different men nationale belonging going truly told rarely please containing claims calmly partly literally cut solved ends died afterwards strikes aimed
questionability	of
questionable	whether in value and if as to that or character practices because validity assumptions assumption how for taste at practice methods means nature when cases quality since is on activities reliability results from behavior business the than legality one shape reputation circumstances but accuracy use conduct authority by utility policy procedure evidence morality benefit data payments characters propriety financial merit moral a actions tactics motives relevance claims significance ethics political authenticity items status sources point transactions loyalty accounting aspects advantage position success morals interpretation decision acts legal even points material about claim origin of decisions things with manner activity way proposition legitimacy effectiveness due ways statements grounds wisdom method act efficacy case judgment virtue areas features what given information distinction kind economic statement social matter source under ones form past integrity conclusions theory
questionableness	of
questione	della di
questioned	the by whether him in about and her as on his me that them or this for their if why at its my it how a because with what concerning but regarding is when to some further before us again from one both all even were our not each only these was since upon closely you during more until many he said document himself had under after every here any documents God without several everything directly your an of myself later who where nor such within either so those Jesus over are herself respecting separately costs among seriously today everyone they recently than people while she now too through carefully would softly Him traditional very thought
questioner	is and to was in that has of who with had asked may would will as or can wants must
questioners	and were that to of in are
questioning	the of and by whether is him look in that his her about their or to was a them as eyes me its on it glance what my techniques attitude at from this why which with can may how your process for gaze will he our you mind strategies has would if one all some had skills should but spirit are technique tone people everything an revealed witnesses each expression approach these glances looks during any God began those when I every not must could himself strategy both before authority she us voice regarding concerning eyebrow were continued such might after than itself went face without until does way they eye over we because smile assumptions traditional myself students stare where style did into even many reveals so under rather children only procedure elicited who everyone behavior
questioningly	at and to
questionings	of and as about which in Of
questionnaire	was to and is that for in on survey data items which were or responses sent with as of used about design are has will study should can designed method by may from surveys asked had at results administered included item would contained measures the also studies concerning form respondents asking developed completed construction containing consisted did itself given regarding could returns distributed forms response before based format must we indicated asks contains but I might so approach a circulated development consisting technique consists methods after have provided filled showed measure prepared covering revealed does administration mailed you because submitted than scores dealing addressed he be into The answers during replies research they assessing it includes when among if measuring techniques provides issued covered only using
questionnaires	were and to are in that or for sent on have from is can which was with of used as completed about returned may administered will at by should had distributed filled designed mailed would given concerning the received could such also regarding asking has
questions	of about and that are to in which as were on for concerning the is or asked can with such from have will regarding at raised you relating may like I we by should arise he posed they must than would put remain was related before involved arising had whether when but it could might affecting do connected involving pertaining without not so answered being she below a need because during if addressed based now has designed presented unanswered here still arose under into over be upon until one require after used between come only submitted this also within discussed correctly include more rather came surrounding dealing often respecting his while later then where all relative did through there themselves above concern listed seem directly using remained requiring first become ask concerned relate facing whose proposed left just most included out appear touching again propounded help relevant both provide shall de set too suggested suggest given even began her involve referred around dealt usually associated lead immediately does having directed how became similar asking him what emerge among each following The carefully bearing seemed why their brought open requires its made very depend right your considered an no honestly make present thus follow already tend together provided go people either according naturally contained refer focus generally beyond covering along lie clearly led frequently since deal indicate except these instead every give mentioned always confronting throughout our yet required per take aimed followed lies begin focused any test other nor coming today simply show aside including himself students allow call found form my them raise went sent growing intended some reflect once What never ought occur fully quickly generated concerns truthfully depends continued prepared qui unless likely apply pertinent get back needed exist reveal satisfactorily sometimes continue seems formulated covered many written outlined properly received demand specifically beginning outside well seriously remaining developed taken see point In cover alone represent serve kept till indicated address showed involves fall calling pertain quite who treated really stated A deserve further necessary historiques referring against worth differently whenever prior pending bring much faced emerged previously inevitably appeared ever gave imply revealed vary ranging me constitute debated typically up almost merely therefore underlying arises helps specific down started afterwards aloud briefly took correct appropriate via makes examined central elicited settled orally actually helped going framed encourage commonly accurately important demanding separately leading explored children belong affirmatively decided implied differ leads freely derived prompted constantly soon ready illustrate yourself been persist far suggests identified better ahead relatives turn difficult elicit called two depending behind contain formed seeking guide assume teachers containing long completely drawn appears provides selected intelligently across pose please appropriately How touched produced obviously shown indicates probably beforehand those shows common lay focusing belonging comes remains determine readily que outstanding offer let invite revolve start unresolved affect seek thrown centered et allowed relates needing effectively necessarily addressing sur turned adequately early becomes guided off Questions measuring meant myself altogether God occurred agitated sought described keep introduced individually ahout mean easily center wrong afterward especially repeatedly gives bear got abound await toward means served force confront herself entirely tended incorrectly frankly certified parents read linked inherent work arc guiding use currently appearing placed change three stand sound fairly ran printed everything receive besides exactly whatever fell asks testing investigated touch look worthy several falling tending raced noted proved direct consists implicit conceming simultaneously men reflected surround tell itself closely grew l indeed resulting answer re particularly purely vital questions assessing primarily follows accordingly anyway largely continually caused politely
questo	caso punto modo e tipo non senso lavoro proposito libro si il periodo mondo che volume genere di campo tempo momento
quests	for of and to in are that
quete	de
quetzal	feathers bird
queue	is of and for length to in at up with size that or was lengths can as are will by on has discipline management until the waiting outside when before time from behind which may name manager de if had a would system using after contains operations i entry where sizes data must so associated but model
queued	up for to in at and on
queueing	system theory network systems networks model models up delay for and time delays
queues	and of are for in at to with that were is can outside on or as the will have
queuing	up theory system for and model systems models delay to time at is network in delays problems of
quhair	the he
quhen	he the
quhilk	day is he was the I wes
quhill	the
qui	est se ne a ont sont nous lui en les concerne in le me fait la peut non leur y vous avait vive de doit font peuvent suit sera fut vient seront va avaient ad cum sunt permet donne ex soit et doivent veut serait pourrait per pro il pourraient aurait suivent te par semble dans constitue ait existe puisse tam porte vont etait reste viennent mal passe ab l devait existent aura rend parle correspond constituent si consiste avoit dicitur estoit je luy auront regarde seraient veulent furent tient permettent fuit auraient pour sait nunc forment sert prend contient tarn Parle signifie semblent plus explique met revient hoc fit donnent conduit on dit servent ante s composent etiam es commence pent que eum portent appartient coute touche devient vivent avoient primus nos sub venit pourront arrive comprend faisait vit rit montre soient sibi post pourra inter eut n forme concernent fe restent pouvait vocatur eft depuis etaient cherche appartiennent nihil estoient tend devrait facit potuit tout au elle sans tamen tombe tollis devaient parlent passent tunc e compte vel voit travaillent contra suis habet obiit produit correspondent fera domine semper venait laisse implique quidem apud allait dicunt tiennent aime joue demande sit erat paraissent indique sic convient nobis jam pense omnes omnia puissent sine marque ressemble manque rendent rappelle bene tant prennent frappe apparaissent propter habitent dicit nunquam ea dort etoit sous agit aient assure autem prouve pouvaient mettent trans mihi hanc blandit sort eam demeure fecit entrent precede secundum parait distingue contiennent du ei savent erant travaille entre cherchent seul exprime faisaient fournit figure accompagnent traite solus chante meurt marche id tous court ils tibi voulait pensent pleure ce vero vise figurent dure miscuit tombent importe rem sum modo naissent fu monte croit devraient coule exige devra arrivent accompagne semblait bien occupe tendent ita out fuerunt aiment vult ut pousse eos montrent jouent haec suppose unit habent prius suivront voudrait assurent offre di nec comporte touchent croient disent pose seroit produisent regne sur traitent change devront vaut traverse avez regardent aut couvre m souvent un pourroit sent iam d lie sint comme continue occupent feront nondum pourtant agissent ai commande vos and postea descend earn demeurent ouvre trouve des potest sua natus permettrait bus tu
quia	non in est per si ex et de absurdum timet hoc cum tunc impossibile ad nihil sic sunt ipse sicut Deus nec a quod secundum scilicet omnis emptores nulla ipsa sine illud haec tamen
quibble	about over with and on that is of to or in
quibbled	over about with
quibbles	and of about over with
quibbling	over about and with
quibus	in non et est omnibus ad de ipse etiam nihil
quibusdam	aliis
quiche	and
quick	to and succession as glance look in enough way reference response action fix eye with movement decision for time of access or step results wit at check about trip decisions change review on return temper smile work steps thinking kiss mind motion recovery but perception fixes overview turn victory survey pace shower breath movements changes answer death one study end hug intelligence profits tour little method that eyes profit solution release a returns by reply reaction run ratio sense stop growth lunch ear search assets passage visit summary success pulse march glimpse start sale lime note flash exit the glances scan answers call prayer calculation brown nod bite service relief money delivery jerk breakfast gesture peek meal walk test learner sketch getaway understanding assessment apprehension shot solutions sympathy inspection move mental buck drying strokes hand drink examination turnover rise word resolution reading wits responses energy shots transition freezing turns turnaround cash schemes fire means retreat escape settlement order development dash breads reflexes progress recognition oven strides growing guide I when analysis grasp identification shake estimate comparison visual sketches notes he phone sensibility burst rundown introduction reactions tempo thrust grin breathing snack if hands example tongue communication rush off intake stroke tempered cup squeeze perceptions process perusal dip ears brain question footsteps twist acceptance you laugh judgment peck insight before once blow observation break breaths trot adjustment thought read acting retort wave count removal calculations is an sharp exchange like cure frozen dinner was sort flick nap snap departure comprehension inventory conclusion motions appreciation setting upward dispatch agreement scheme information pass words light witted it short they nor from cooling discernment parts flashes questions bursts promotion imagination view shift lesson cuts military thinker flight because wash sweep intuition list disposal route determination sip impression ones use fingers feet good cooking right moment now feedback fortune upon cut evaluation descent job jump flush pull opening ways side into wealth nervous draw left bath game tears trips sales judgments instinct rate withdrawal kill approval appraisal transportation clay picture retrieval voice reminder transfer repartee learners touch anger than riches increase adaptation explanation economic leap advantage flip refresher course series methods wink round application meals wins ride strike entry moving bread report advance intellect so tips consumption moves weight sound manner expansion result looks despatch transport decline adjustments idea second sympathies brush after sight gasps phase hello repair attack she learning drive estimates tug swim head firing set transitions get meeting flesh frown diagnosis stab attention sigh conversion blood detour bright feeling feelings take sandwich defeat hit drop effect journey gulp alarm jab we running embrace supper tests screening operation victories gasp quick fortunes blows aim grab collapse knock demise reversal destruction vision pick implementation kick impulse actions gains beat trial shifts peace spin remedy source sideways up swipe interest lift sand stretch jerks man roll adoption message double replacement conference consultation killing stride penetration tempers restoration spirit chat business speed divorce pat cry bow studies description acceleration improvement hard passages command out execution gestures production stops component rhythm disconnect push first worker too half water salute quiz surprise transformation intervention goodbye closing ratios transit conclusions backward repairs approach clays cutting surrender yet circulation snapshot procedure onset suspicion minds over fall decay child downward through switch glimpses turning flow are healing cures rinse phases resentment tap halt tricks financial conversation loading dismissal swing memory sequence handling war walking reduction two silver measure black starting speech dance surge spring absorption discussion checks spread marriage stir back self starts rejoinder preview re examples responsiveness help indication political market coffee detection briefing menu initial hot justice campaign puffs recap clean telephone links advancement thrusts though fancy contraction decisive whisper swallow pressure exercise U passing deal road puff orders rounds heat marches apology pain story then orientation beating comparisons
quicken	the and his their our your my in us it them her a me its into as with or to him all at you
quickened	by his the and her in their into to as with my pace pulse at our its us interest when sense or a breathing except breath heart from it together again me step them him tempo
quickener	of
quickeneth	whom the them
quickening	of the and his in pace spirit power influence Spirit their to her as pulse interest or breath its our into influences tempo with impulse life my is effect
quickens	the and his our in to it all its as into with us
quicker	than and to the in way pace if you or at we results method for on response it with rate by they when access he as recovery time will return action but of progress I tempo route that this growth because movement still service means motion ways delivery returns is process methods now a step from development
quickest	way and route to possible method of means ways time in path descent road results manner
quicklime	and is in or to
quickly	and as to became in than that from the enough into followed with become by on made at through turned when found or learned be after for put if realized spread becomes took over discovered away came moved changed established got learn out developed find brought because back down but lost added he up recognized began passed forgotten went returned they it toward before reached so a set removed replaced recovered get without becoming disappeared filled fell gained across pulled adopted decided left taken grew see you come around ran gave looked agreed turn is formed she saw rose I abandoned under closed accepted lose make absorbed picked led responded have caught gathered towards dropped change dismissed move opened said proved won replied discover identify along had settled joined we take told changing what develop about raised identified sent now acquired faded was suppressed covered cut done drew restored reduced seized did perceived disappear apparent upon during answered round lead destroyed determine stepped turns while bring explained built return exhausted converted learns dispelled emerged realize produced reach can called follow understood regained walked go once grabbed placed between withdrew past run transformed add of forward scanned grasped checked realised dissipated adapted available moving determined slipped assumed showed pass this carried will resolved jumped obtained behind sold corrected pushed drawn concluded create disposed vanished transferred assembled released broken prepared expanded achieved shifted organized locate recognize arranged broke fall read overcome asked shut forgot dispatched finished cleared appeared how forget re seen eliminated surrounded revealed growing rejected pointed attracted stopped ended adjusted withdrawn cooled turning applied entered threw dispersed one glanced felt give accomplished grow succeeded reversed dried died loses wrote captured disappears introduced respond increased climbed do noticed among started extinguished establish moves translated throughout demonstrated leads show wiped killed off following remove all retreated gets lowered repaired review noted given crossed discarded dressed takes tried die comes are would changes resumed produce until let confirmed mastered gone earned detected drove forced then consumed dissolved reveals able his whether driven understand used laid secured passing returns completed evaporated subsided informed relieved defeated passes destroy follows evolved located recover build fill swept approved washed begin convinced fade adapt overwhelmed an does recognised approaching assimilated ordered reaches mounted again silenced since tell using too finds dashed extended adds gain disappearing reduce being access even sat switched reveal against stood solved been makes worked form gives sought swallowed tired look grasp developing backed adjust evident attained there were thrown develops check these learnt lifted getting arose interrupted arrived within occupied discovers falls spotted appreciated acquire realizes collected assess degenerated taking rallied crushed collapsed dubbed subdued pick brushed hid signed deteriorated assured leave rolled snapped offered may created coming losing reminded performed arrested fades goes rising here escalated your embraced stripped shot cause switch recovering rise increase decide buried snatched making packed sprang fading tied fatal like scan aroused break close end open shook brings averted obtain loaded where emptied advanced superseded inside running handed received shows announced constructed sensed their descended met disillusioned enter due slid repeated which gaining learning reassured spent cured spreads calculated indeed erected reflected finding executed detect perceive her retrieved shown overcame draw pull revived struck improved drop select provided appear notice fled runs clear promoted known restore poured wrapped assessed sank departed copied depleted summoned despatched point provide mobilized generate jump should things overrun raise terminated remedied communicated thrust altered approached paid bought separated eliminate melted rushed eroded cover result shift dry incorporated replace observed grown headed sketched cast affected declined ascertained rebuilt spreading reverted any grows reported overran pressed responsive returning has succumbed vanish ushered implemented settle drops rises puts thereafter place issued catch recovers aware searched frozen accessible could start onto closing assume effected heated installed overpowered satisfied written healed thought figured exposed unless erased reaching resolve modified filling denied tire disabused forms begins just convert routed attain send shed absorb going spot prove ducked recalled dies establishes cease discerned fired shattered those nor examined focused supplied feel apply dialed drained say taught deteriorate declared gather surrendered some shoved swung rendered granted obeyed my controlled bent reviewed increasing stop dealt exploited disintegrated degenerate increases folded inserted adopt dismounted challenged kill putting overtaken expanding adding persuaded scrambled evaporates achieve overshadowed attached distributed stifled transmitted forthcoming cleaned produces bored people our summarized rounded helped surveyed divided attacked retired conquered complied launched leaves published shifts aside involved displaced ate establishing countered exhaust breaks distinguished master note reduces diminished ceased perish surpassed home hung digested removing retorted hit subsides evaporate beyond withdraw outdated shifting exchanged arrive overtook intervened circulated subside rather imitated fixed appointed warmed abandon such supplanted falling wear amended write generated held regain conclude proceeded tore transported evaluate labeled devoured resulted escalate not stuffed wore locked exited apologized flipped destroys transfer looking trained dominated solve agree burned time roused improve transform reinforced acted repressed sees composed flew delivered compared outgrew calculate ahead scattered replacing dismiss asserted use answer undeceived responds conveyed engaged admitted fills correct dissolve search quelled removes failed married knocked dissipate assumes expand integrated donned bringing banished together endorsed apprehended suggested kissed pulling selected retrieve diverted penetrated interjected dug repulsed claimed obvious dries ruled yielded degenerates dragged insert sets revert worn devised dissolves recruited ratified sense disappointed engulfed call figure scribbled lay deployed release eaten eclipsed know identifying drawing gathering slip press tossed undressed squelched remembered emerge rejoined work discern recognizes excused leaving its straightened caused spoke freed undermined acknowledged throw succumb discouraged giving managed afterwards drowned cooked drive vanishes appropriated causes revised expelled counted each ascertain dismantled must vanishing building burn evolving consolidated react only lest hurried catching scanning unloaded improvised reestablished continued dispose demonstrate sealed alter yield drafted impressed forgets pulls hidden plunged accept though served presented waned pay results rectified forming bound sized The condemned named chose smothered lit assemble join spun outside discharged hauled either identifies stated escaped perform prepare try collapse realizing hired fallen disseminated ensued calmed surfaced carry narrowed kindled hushed dismisses outstripped grab ready encountered absorbs picks scooped resume accumulated decreases sorted renewed closes who drying oxidized seize landed view volunteered overwhelm drank eat separate touched untied interpreted heard also looks appears points reverse covering wipe arise whenever dissipates both indicate obliged ascended reacted draws diagnosed convince jerked traced successful initiated erode succeeding slammed display disarmed enveloped rubbed indicated summarize adapting directed realise finish dispensed deteriorates multiplied meet obliterated sink yet push heal acquires enacted melt tested appreciate fastened raising determining voted covers mixed administered fly evacuated supported explain chilled alienated retreat estimate responding outlined marched diffused help pour analyze submerged slipping displayed escorted surmised expressed settles showered sort nodded rewarded choose accessed negotiated escape cool assigned test reconciled decomposed darted opening decay diminish damped upstairs effective locating split reappeared filed bore denounced induced manifested purchased connected seek blocked verified evaluated quenched accelerated rid approaches via enters lower tires receded wears saturated compare sobered beneath resigned rinsed rode cross jotted stirred step processed stir accumulate withdrawing exceeded builds deserted sell fitted whisked immersed ruin sped relayed crawled checking diminishes organised overthrown tucked render smoothed complete unlocked degraded risen gains dispel merged win substituted drifted upward evolve focus punched regretted hide ruined distinguish demolished dropping tells rescued retracted raises filtered associated everything examine masked new setting introduce consume producing progressed right soured leaned fulfilled dwindled cooling concealed isolated ripened swelled
quickness	of and in with to that or is at which as
quicksand	of and in that or is
quicksands	of and
quickset	hedge hedges
quicksilver	in and is mines was to mine of into from deposits will at
quicksort	algorithm
quicquid	in est
quid	pro sit in est of a de for and non ad to aliud enim nimis is et ego on or juris ex mihi tibi sibi from si
quidam	ex
quiddities	of
quiddity	of or is and
quidem	in et est non ex ad ut de per
quidquid	est
quiedy	and in to as
quien	se le no lo la es sabe me en los
quienes	se
quiera	que
quiere	decir que
quiero	que decir
quiescence	of and in is or to during which was
quiescent	state and in for period cells or current point conditions during phase until operating periods stage condition value as at collector prominences centre center but fluid under
quiet	and of in for as the place life voice time way about but little room that at on man again to corner down dignity enjoyment when now until or night street was possession a country evening spot with enough times day water one during waters while manner her sleep smile by here streets home is moment title days him moments his all breathing after confidence it them desperation house hours so village except beauty tone till mind spirit revolution retreat hour people town there air period old talk environment places conversation contemplation I because which residential than their diplomacy under strength dinner words before reflection he area satisfaction study Sunday atmosphere around you rest work side like self this ones meditation person morning determination from word neighborhood evenings ways afternoon conscience if state pool my girl young sea joy family years woman men eyes periods summer face happiness part your since sort tones walk retirement had without child space assurance lives road valley boy rooms lake stream humour elegance charm garden peace courage humor death authority pride they then nook pools she rural repose within seclusion good resting river yet scene sense thought conditions are resignation game surroundings acceptance power reading wedding grave laugh reply respiration voices operation out inside chat haven heart reigned English city solitude music nights domestic prayer pleasure sector demeanor submission once fields along too existence disposition corners intensity eye even hotel our we nature backwater efficiency throughout location amusement drink activities any look world were today areas up an kind games light back things over where presence mood answer calm grace affair countryside will homes setting sun sound type Sun routine would through winter suburban these walks bay contentment villages activity fellow comfort simplicity tonight woods play me conviction surface outside meal zone figure tears between darkness despair green breath laughter sounds office influence course week ride long observation among force lane sigh manners end smoke serenity children habits sitting sky settled slumber ceremony gentleman heroism prevailed scenes pond half community table discussion pleasures living restaurant suburb harbor just weekend sadness order square reserve waiting standing firmness chuckle though attention forest streams movement beach household only stroll passage lanes chamber church interval dark hills churchyard stars landscape year upon inner conversations patience grandeur persistence stillness roads cove flow earth refuge mountain guy irony support most style talks student New citizens horse nooks business stretch land certainty hum habitation pursuits peaceful valleys background fashion demeanour feeling behind faith bays understanding soul fell resolution love us Sabbath contempt progress inspiration hand wisdom has sectors devotion lunch The thoughts save Christmas can harmony character folk weather came no ease months approach courtyard seemed composure triumph spectator blue private intervals apartment bed mode listening content may emphasis those acquiescence melancholy murmur group speech section tree spots step growth minutes running thinking close condition form fun pastoral statement descended fishing concentration island knock body communion farm endurance houses lakes whisper well depths energy holiday neighbourhood residence observer settlement pace rather insistence shore harbour some meeting nor song sanctuary steps himself backwaters path courtesy spaces enthusiasm pipe library note paths company month competence decision delight spectators visit interest past yourself reverence should cul working round American park baby behavior industry expression shade hands retreats its relaxation unassuming response campaign scorn remark social passion spell reigns movements region gardens supper affection regions command returned action afternoons anger lately season circle ever exterior question process hamlet obscurity earnestness unless cottage deliberation rage thing could themselves Saturday cheerfulness grey drive development field occupation students trust rhythm compared bar gray indeed service temper majesty reign gravity passages footsteps ending weeks lady parts middle tune temperament hope colors kid cup situation party indifference shades intimacy resolve tastes crisis unobtrusive provincial moonlight followed loveliness celebration behaviour women did government more glow be expiration alert interlude meadows dead public myself inn steady sympathy story luxury withdrawal security personal fury together investigation resort gaze pursuit citizen sarcasm scholar members assumption zones towns joys excitement coves autumn seat respect still exercise
quieted	down the by and her him his them in their my as for with to a when me all at
quieten	the down him her them
quietened	down the and
quieter	and than in now times life place voice moments tone but way as waters water the time of for or days at streets mood
quietest	and of place
quieting	the of down effect and his her their them title influence him a
quietism	and of in or
quietly	and in to as at on for with into but by that out away down through from behind said left along about until slipped while took enough up dropped back under over without the went asked beside put when made among watching together walked closed waiting or so told opened he passed replied seated withdrew after before returned upon moved than submitted entered around reading looking remarked listening accepted across began sitting home now removed working settled taking till submit set off turned here of taken there she sat a let got laid grazing observed during spoken toward ignored within disappeared go take smoking going abandoned I talking answered all retired waited enjoying if making wait sleeping resumed dressed confident near followed like watched continued enjoy feeding gave towards where against moving between resting they past slip stepped placed round eating have buried informed observing shut awaiting leave allowed awaited dispersed shelved approached doing been died forward asleep resigned assumed preparing next explained forgotten married walking acquiesced withdrawn alone carried sent again drew did arranged accept inside departed pulled say pushed read thinking beneath one closing because happy pursuing looked announced sit came what outside done added led playing standing worked pursued prepared listened brought engaged aside suggested picked this gathered determined gone it called disappear given get occupied folded disposed stood slipping ordered had transferred crept handed rose weeping agreed elegant held stole enjoyed released established absorbed drinking make joined was whispered come await bought slid saying sipping being spoke side takes we getting crying putting lay replaced building studying trying walk downstairs ask pleased is proceeded changed kept amused withdraw says staring throughout supported yet fell upstairs surrendered drop encouraged raised passing you watch look expired holding close suffered pass open give pointed sobbing turning started return discussing gathering reposing leaving dismissed goes just be lying faded paid do smiling effective lifted efficient climbed introduced retreated following writing move conducted flowing discussed assured accepting crossed become
quietness	and of in that to is was which with as for about
quiets	the down
quietude	of and in that which is to was
quietus	on to make
quill	pen and pens in of or is to feathers from work with into was longest on feather for
quills	and of are in were on or to upon for from with longest that
quilt	of and top is was in on that to with for over from or made as pattern around patterns up the blocks she a block by making which has at design batting will had back can I are together pieces designs shop it tops you show off would out sandwich
quilted	with cotton jacket in and by petticoat silk jackets coat satin fabric robe
quilting	and bee is bees frame in thread parties stitches design party designs lines was or pattern patterns
quilts	and were are in of for to on that from made with or as have
quin	et etiam
quinacrine	mustard hydrochloride
quinary	system
quince	and tree is trees jelly stock
quincentenary	of
quinces	and
quindi	la di il
quinhydrone	electrode
quinia	and
quinic	acid
quinidine	and is sulfate in or therapy may on gluconate
quinientos	y
quinin	and
quinine	and in is was or to sulphate for sulfate as has may are hydrochloride on should from with were pills by tablets treatment at had will which solution
quinoa	and
quinoline	and
quinolinic	acid
quinolone	antibiotics
quinolones	are
quinone	and is methide reductase in oxidoreductase
quinones	and are in
quinquennial	period periods census
quinquennium	of
quinta	essentia
quintal	of in for and
quintals	of per in and
quintessence	of and is
quintessential	American example expression form New symbol to
quintessentially	American a English modern human
quintet	of in and for with is was
quintile	of in and is
quintiles	of
quinto	die
quintupled	in
quinzaine	de
quinze	jours ans
quip	that about and of or to was in
quippe	qui
quipped	that to in as the with
quips	and that about of with
quire	of a the and that
quired	to by for the in a of
quirements	of for
quires	of a the that and
quiring	to
quirk	of in that or to and
quirked	a in an up his
quirkiness	of
quirks	of and in that or
quirky	and little sense
quirt	and
quis	in dixerit non nostrud autem est de enim ex custodiet
quisition	of
quit	the his their and smoking this of her it school my work a in your that or for drinking on at when because working after trying to rents our rent them before him being talking now all as playing if you claim rates me its Paris rate using while worrying with without India until going thinking fighting teaching is France England these doing college looking by making writing taking us one from high running so eating an was right Rome but London coming any date calling early reading asking altogether such politics too cold office acting farming business again those crying just within thy during jobs The even himself than what life not buying command I then laughing breathing over Spain themselves Italy attempt fooling rather paying listening bothering till under thee saying wasting unless singing complaining baseball every immediately giving given speaking yourselves selling
quitclaim	deed deeds
quite	a different as the so well clear sure possible another an right similar often common certain in clearly distinct small impossible apart likely simple large true enough close simply good out high like at natural naturally ready easy recently some easily willing obvious evident difficult sufficient differently unlike understand low literally happy capable independent new possibly satisfied unable early to young complex frequently aware important free alone correct limited satisfactory safe know successful what prepared near beyond still independently content remarkable rightly useful wrong unnecessary normal familiar probable suddenly generally separate consistent strong dark apparent unknown effective all rare specific agree reasonable frankly long obviously general rapidly contrary accurate popular plain comfortable that other inadequate interesting closely forgotten useless seriously recent properly equal variable significant late lost serious by without short able incapable accurately far pleased complicated correctly extensive unusual explicit adequate convinced dry extraordinary understandable old see up stable expensive openly quickly hard dead readily believe unconscious otherwise unaware exceptional definitely unexpectedly soon plainly appropriate substantial open straightforward acceptable make of definite surprised fit indifferent ordinary sensitive foreign full understood unique finished cold too conceivable fair considerable unexpected active recovered on freely complete commonly ill compatible such forgot confident ignorant real widely severe successfully outside probably beautiful diverse nicely how helpful uncertain necessary characteristic varied warm proper extensively nice exhausted strongly justified get arbitrary typical impressive calm plausible explicitly fresh conscious smooth modest suitable made perfect narrow proud attractive taken irrelevant striking effectively friendly happily gone numerous distinctly flat frequent harmless opposite unlikely upset empty feasible mad within modern deliberately yet comparable wide surprising usual regularly straight through distinctive marked peculiar reasonably broad poor white naked weak pleasant insufficient logical thin heavy innocent mistaken legitimate uniform frank away fast put alien misleading unrelated insignificant black time certainly satisfactorily excited unconsciously positive got calmly dramatic respectable unfit sophisticated special rapid unsuitable powerful comfortably analogous regular dissimilar remote one reach overcome used valuable unprepared determined over sick tired wonderful this clean fond evidently visible inconsistent interested two sharply concerned slowly honest hot aside fully thick slow knowing healthy honestly consciously soft round cool elaborate angry firm deep dramatically absurd pretty half agreed astonishing detailed light considerably charming beside sound reliable knew prominent constant delighted efficient competent worn busy irregular convincing widespread strange pale done logically helpless essential lately hopeless painful remember forget heavily directly inappropriate critical sincere human superfluous understandably flexible pronounced intelligible silent firmly adequately casually come impracticable astonished rich irrespective dangerous noticeable anxious sharp accustomed worthy secure amusing incredible contented incompatible unimportant specifically big self distant changed bare amazing handsome pure unintelligible advanced be thoroughly incomprehensible sensible erroneous relevant impressed costly precise settled prevalent deserted revealing agreeable consistently untrue conservative subtle down immaterial lovely sufficiently oblivious cheerful bright precisely devoid unworthy invisible three ashamed isolated obscure involved uncomfortable decided lengthy awhile steady adept abundant original alive unconnected resistant ridiculous realistic drunk identical regardless transparent famous brief vague reached significantly unacceptable radical favorable convenient meaningless unsuited unrealistic normally novel opposed delightful work removed bad moderate unsatisfactory markedly welcome practical unnecessarily disappeared genuine shocked bring unconcerned do uncommon blind rational false quiet tame badly wealthy have appropriately secondary startling frightened broken his safely unequal exciting legitimately off red shallow catch intelligent rigid trivial primitive wrongly negligible minor spontaneously confused arbitrarily touching sincerely tall glad hardy absent fine above parallel robust promising valid ripe unaffected indispensable restricted follow unmoved substantially into funny unprecedented innocently bewildered ineffective destitute intolerable liked extinct unreasonable twenty something inexplicable untenable smoothly intense against separately worth conclusive sober abruptly enthusiastic superficial sorry dependent accidentally controversial steep grasp influential apt nervous literal forgetting challenging inconceivable been unfamiliar convincingly incorrect conventional motionless overwhelmed profitable sane relieved across say completed covered loud mild improbable filled clever wild rough match conspicuous heterogeneous spectacular stiff personal commonplace fundamental quietly comprehensive meet highly exact lively given negative bluntly un practicable loose largely grown unhappy failed deliberate enjoyed level liberal disappointed fairly wet predictable realized left traditional figure closed fascinating confusing generous alike disparate homogeneous himself solid carefully insensible justifiable succeeded understanding contradictory place informal cheerfully inaccurate conclusively vulnerable curious unstable susceptible believed remarkably evenly encouraging uniformly reconciled completely unclear just powerless unreliable destroyed candid disproportionate particular divergent favorably unfounded realize insensitive restored direct startled formidable efficiently abstract altered relaxed formal vividly unwilling loudly amazed unpredictable shut four five briefly worried sad justifiably worthless lacking radically proficient customary intimate unintentionally succeed strict unfair insoluble decent willingly desperate subordinate expected awake soluble set hidden unmistakable accidental comprehensible problematic cut inaccessible undisturbed manage severely unjustified fashionable inexpensive knows representative detached trust doubtful profound superior tender take dense alarmed refreshing brilliant basic explain disturbed handy eager deeply irresistible shocking desirable appreciable futile universal where inferior appreciate steadily depressed green exceptionally with there cheap neglected justly permissible from six comprehend admit excellent mature demanding miserable unwarranted gently took untouched faint sometime unfitted under fitting beneficial irrational incomplete passive disturbing truthfully tell my admirable approve ten manifest candidly fantastic why and died knowledgeable sensibly elegant overlooked violent sympathetic hostile conceivably overwhelming alarming truly fluid credible resolved tight annoyed composed dull frightening needless odd inevitable fragile unthinkable absorbed expert scarce carried abandoned restrictive believing distressed orthodox broadly reluctant decisive tedious cured inefficient attached unpleasant appealing toxic elementary unchanged delicious won technical spoiled concrete poorly abnormal for indignant legal unnatural sudden sweet disposed caught ancient productive incompetent optimistic positively aggressive imagine erroneously plausibly prosperous applicable embarrassed skilled crowded feel reaching ambiguous agitated instructive outstanding vocal inadmissible charmed hear obsolete satisfy deaf extinguished ceased assured keen exactly neatly central crude little favourable rudimentary accessible touched gay minimal unbearable stupid emphatic pleasantly careful similarly cumbersome satisfying shy impractical artificial revolutionary tolerant even fixed strictly opaque competitive managed peaceful selective seem private tolerable impassable shaken innocuous inapplicable spent improper delicate volatile non coolly worked compelling uneasy go thirty puzzled uneven extreme her forgiven informative ruined herself genuinely bizarre pleasing smart resigned gentle unreal bitter unwell unjustifiable fat emphatically plentiful impatient automatically subjective mixed incidentally enjoyable humble suited casual impervious symmetrical lonely entertaining lose elderly accept fortunate intact brittle extraordinarily obliterated neutral thorough confounded unperturbed cover perceptible perfectly turned pointless loosely unsuccessful feeble magnificent amused adamant unaccustomed audible rationally touch responsive suggestive hungry overpowered matter unnoticed unambiguous tough keep healed mysterious barren subdued succinctly entitled compact crazy ingenious chilly narrowly local categorically great passed indescribable thrown dreadful escaped discouraged myself indefinite crucial noisy standard skeptical vigorous animated mean peacefully idle fertile think unmanageable naive vanished cheaply indistinguishable drastically their impersonal forcefully romantic noticeably unaccountable amenable entire persuasive confidently decide outspoken figured individual weary palatable dare afraid embarrassing destructive intricate enjoy achieved spontaneous surprisingly unequivocally incidental square accepted mobile elastic after broke specialized astounding according grasped equally pertinent splendid heated tasty troublesome give telling separated appalling distinguished unacquainted bald unwittingly concealed rude fascinated emotional insistent universally unmistakably moved fun blue readable vigorously risky boring silly gotten overcame insane manageable daring ugly forgave imposing legally foolish thought objective unparalleled beautifully realise cross disgusted meaningful prominently vivid uninteresting tricky realizing illogical forgive durable bold inactive singular spacious or congenial tiny unbelievable rarely its persuaded faithfully unused abrupt informally stunned grand versatile mastered known uncalled eloquent puzzling agrees careless unforeseen straightforwardly awful jealous exposed realised intriguing sparse ineffectual overshadowed marvellous eclipsed escape picturesque valueless implausible learned horrible gratuitous ignored polite kindly tightly irreconcilable involuntarily awkward harsh blunt quick ambitious distinguishable conceal English devoted illusory hopeful intimately contentedly ruthless grey disconcerted massive persistent kind stunning divorced accomplished correspond unequivocal understands annoying moving unsuspected disappointing staggering stout acute misunderstood terrible beneath audibly slender elated articulate softly objectively pathetic drastic forty yellow struck breathless unambiguously creative enchanted consonant authentic gradually brown fifty visibly approved frustrating imaginary reminiscent ludicrous random inert fathom imperceptible fearless look exempt promptly disinterested fluently unheard routine stringent recall serviceable unjust developed deficient attained identify gray perpendicular inclined imperfect established harmful actively fill realistically steeply aptly uninterested live tense distressing receptive colourless measure marginal coherent indefensible coarse hide found equivalent illuminating unusually unjustly recognizable experienced rigorous dizzy presentable legible rewarding linear faded distracted few fulfilled intuitive erect incorrectly lucrative moist cleared refreshed speculative came double permanent laid gravely back inexperienced seven furious upright faithful achieve sizable your erratic terrifying enormous slight lucky strikingly wise violently cordial scared supportive cautious painless appreciated belong terrified intentionally shake fail knocked looking unanimous find senseless let extended preposterous fluent melancholy damaging typically surely alert had everything irregularly progressive aloof groundless define uncharacteristic suit believable inconsiderable sizeable fruitful innovative giddy unabashed vertical impartial predictably civilized below transformed vexed trustworthy tentative wanting daunting devastating inconspicuous matched religious unconvincing mechanically yourself twice merry first pessimistic potent fortuitous vain expect gratuitously needlessly orderly undesirable inconclusive unavoidable fierce sunk functional atypical incongruous grateful conveniently equalled outrageous frustrated unsafe particularly disconcerting stressful gave temporary phenomenal perplexed bewildering obscured favourably tangible lightly past undeveloped public frantic invaluable recognize advantageous fallen notable infrequent eight hurt fifteen unpopular liberally external gradual enchanting run coincide intoxicated unattainable illiterate humorous bearable inaudible suspicious truthful pervasive brave childish rid unfortunate boldly horizontal behind it tranquil dazed forgetful meeting talented grave incalculable sterile blank surrounded ironic voluminous circular eighteen reliably shortly involuntary dissatisfied formally capture talkative immune unintentional laborious alright appreciably getting continuous master overpowering nasty shamelessly amiable stationary inseparable diversified dim unsettled slim ideal saw ambivalent skillful fatal being hysterical spoilt passable disastrous amicably sore dried disconnected hazardous neat solitary ample roughly explicable whole systematically concentrated inadequately sixteen disgusting irritated hit luxurious mistakenly jolly briskly dubious damp dirty inadvertently immature inelastic admirably economical decisively becoming attain lame indiscriminately fearful apprehensive making porous distorted melted excluded mechanical forsaken undone inevitably our pointedly dazzled around meager naively threatening hollow handsomely hold tenuous those comical silently dynamic bulky notorious thickly inexcusable forcibly indistinct become entirely felt illegal stopped reduced localized irritating docile raw rigidly unaltered liable reaches benign nine unremarkable fitted adaptable disappear unnerved astounded fatigued captivated serene exquisite desolate unfairly disagreeable intensive distraught extraneous lucid unreasonably ended voluntarily civil decidedly finish twelve dumb systematic unexceptionable forgets guilty various professional fragmentary constantly illegible fails diffuse falsely irresponsible automatic inoffensive dazzling marvelous indeterminate reckless unruffled unjustifiably rotten undecided fancy concretely uninjured indirect disabled fruitless miraculous trusted excusable affected mundane unrecognizable voluntary divided describe vital characteristically cast palpable magical upon akin apparently politely unfavorable noteworthy disheartened unobjectionable eloquently brilliantly asleep reassured uneducated unconcernedly untrustworthy prolific convince autonomous creditable cynical break impenetrable fortuitously seen exclusively many brisk sociable lawful questionable unscrupulous impartially share conversant brutal liquid horrified enjoying add offensive leave elusive undeserved dejected prolonged loses thrilling crushed pink speechless pragmatic answer destroy thrilled lived attentive responsible read unprotected densely uncanny restless discouraging gets intimidating reconcile uneventful modestly deceptive uncritically arrived defensible unattractive acid trifling eagerly savage reactive superseded gratifying numb pointed prone baffled especially offended inconvenient paradoxical unsupported extravagant absolute anomalous bored humbly dear unconventional privately home admissible stimulating contemporary concur exotic fallacious fiercely equals flattered makes reserved minute nearly reproducible negatively account regained despair unawares restrained flattering allowable loyal fits fundamentally unharmed always precarious synonymous wisely earnestly effaced upsetting chaotic detrimental expressive scary intentional unscientific blatantly celebrated tempting idiosyncratic perceptive average graphically takes unrivalled undistinguished wretched current persuasively feminine ignoring messy democratic succeeding recover bear major perceptibly enlightening cruel fanciful wonderfully counter dared dispassionately inflexible wasted intrigued permeable American astonishingly unimpressed colorful balanced unsound eccentric elevated excessive superb harmonious worthwhile soberly The unmindful swiftly insupportable descriptive generously impotent every unsure cooperative frozen reassuring unanswerable seemed incoherent exaggerated sturdy uninhabited traumatic rested unorthodox delirious abashed unpardonable untypical selfish material urgent flushed prudent insecure defenceless dissolved publicly haphazard secret unhurt disregarded au passionate unexampled decently freed confidential resilient colorless seventeen static plump scientific troubled effortlessly dated sanguine shameless blurred outgrown discernible averse elaborately exhilarating fourteen differing discrete disappears handily en hoarse unworkable securely consumed breathtaking desperately gaily respectful wholesome quite overtly forceful rugged undetermined merrily express refined reversed disruptive smitten patent comes wearied exhaustive final turn exclusive vast wary materially depressing competently personally dominant intractable limp cleverly unrepresentative affectionate monstrous painfully vicious uncritical please solemn plastic abolished sentimental unevenly mistake dilute witty buried losing rigorously unarmed cozy unsettling drowned solemnly relative soundly youthful workable uninfluenced leisurely untroubled sceptical coldly incredibly premature viable musical callous peculiarly when nearby baffling strangers misplaced suffice doubled mediocre deadly unimaginable overt categorical frail re withdrawn said respectably unavailing secular cognizant superficially circumscribed oppressive intensively heartily partial fall killed unafraid unreadable energetic grieved usable ruthlessly appalled shrewd affecting unsuccessfully strenuous artistic void did picture affordable sixty but lenient irrationally meagre conspicuously dusk subsidiary missed profoundly inappreciable heroic French scattered focused exhausting frightful absurdly incurable explained burdensome flatly saturated classical amiably dignified powerfully senior brought conformable indicative timid unmanned hilly illegitimate lax provocative indifferently overjoyed impersonally congruent deceived carelessly backward dif untrained antagonistic wicked indisputable adapted commendable defensive warmly ring stupefied matches illegally expressionless viscous abundantly met heedless di poisonous pull unexplained sketchy intensely dismayed unhistorical transient tipsy stubborn unresponsive amazingly contrasting angrily elegantly de unimpaired infrequently aged unsuspicious memorable snug penniless looked subsided European departed dependable nominal tenable strained better noble suppress transported muddy separable perturbed objectionable proudly unequalled infinite heart unproductive uselessly astute vulgar hopelessly repugnant hilarious conform ornamental patient unmolested swollen displeased philosophical went profuse dispirited bleak domesticated nude con problematical ignore unofficial unintended unobserved aggressively want confirmed patently complimentary bereft I hideous end kept specially imaginative lifeless baseless instinctively unsophisticated committed crestfallen collected blatant warranted scanty justify gloomy critically hypothetical protective immovable is aghast dispersed uncontrollable agreeably stand brightly unwarrantable skillfully intolerant fearlessly decayed graphic hesitant grotesque imprecise unprofitable unashamedly inaccurately hid conquered distasteful incomparable divine unconvinced illogically eleven labile banished hardened envious antithetical unqualified peripheral profitably immediately slippery rudely astray expansive banal inexplicably deprived preoccupied malleable unnerving glabrous simplistic suppressed tractable subtly tragic transitory determine equaled succeeds harshly prosaic vascular die inventive enthusiastically differ unforgettable drawn sensational stylish sticky apropos deserve irrespectively cosmopolitan defeated perplexing physical baldly complementary love composedly irrelevantly redundant omitted cheered shaky water unendurable impregnable conventionally graceful earnest fragmented fictitious spoil academic comprehending filling dressed irritable comforting okay acidic burnt salient inappropriately unlimited more edible affable together passionately shattered anti rural vehemently guiltless present eclectic radiant determinate uncovered randomly undaunted hazy brutally occupied inexpensively routinely enter differendy encouraged forthright available became affluent control bland stark unbroken conceive driven laughable secluded onerous recognise prostrated gracefully exemplary admitted unselfconsciously chummy prettily undeniable intelligibly improperly immobile unapproachable empirical thirteen imperative inimitable tasteless ephemeral reconcilable part timely apply unembarrassed insufferable tiring these envy unaccountably fittingly cordially happened attainable formed grim unspoiled
quitrent	of
quitrents	and
quits	the his and with her it for or its a in on this after at to when
quittance	of
quitte	la
quitted	the his it their her this that him my Paris England them a me for London in our France Rome us its by office with all Italy to and at India on
quitter	le la
quitting	the his time their smoking it this a her and my school of that work or your for England is in them our him to its Paris office at all on because was France London as one when
quiver	of and in with full on as at to is like from was that for under or when through ran over a
quivered	with and in as like at on a under slightly through from to for when beneath all over again
quiverful	of
quivering	with in and lips of voice lip on flesh like as from body at under to mass hand nostrils wings hands light all motion nerves through breath face fingers leaves limbs heart mouth slightly air over a jelly sigh for form chin beneath
quiverings	of
quivers	and of with in on at full
quixotic	and to in quest attempt as
quiz	show shows on and to questions is in the or for program him programs that scores me you at was game will her with of each them about score are
quizzed	him the me by about her on them
quizzes	and to are on in or for that
quizzical	look expression smile glance and eyebrow looks eyes eye
quizzically	at and as for
quizzing	glass the me him and her
quo	in and of ante warranto is for was as or by to that with which on non would will are at ad est minus has can but modo until from than may power et harassment rather should tempore were had could through because against powers sexual between se bias while magis basis nihil the pacto vadis policy must de before animo without when fit a etiam within pending have loco die nunc res omnia so supra arrangement sunt me under casu be omnes if point might quidem te agitur established maius cum
quoad	sacra the hoc nos
quoc	ngu
quocumque	modo
quocunque	modo
quod	est non in ad si de sit ex per cum a ab ipse et Deus omnes dicitur he ego idem erat nos etiam semper hoc omnia homo ipsi nullus quidem pro habet sic ubique ille ipsa nihil sunt fuit tamen sibi nulla tu damnum ei fit licet res she dicit nec omnis inter mihi prius aliquid intellectus sint sicut sine nunc ea haec ita aliquis secundum absit the illud potest tibi ante illi dictus natura ipsum se esset quid anima illa magis quidam Christus nobis esse nunquam tunc post apud me unum fieri ibi dictum vis attinet ista bonum contra autem is tam propter quilibet te nemo dominus qui factum verum vide jam facit una bene quis possit I predictus movetur sub aliqua nullum corpus omne vocatur lex talis ratio pertinet Dominus neque vel quando homines eo nee dicta ut enim hic omnibus iste primo super genus hie scilicet supra voluntas unus ilia habeat videtur maxime deus eorum primum vos rex significat minus nullo eum nomen dicti eis
quodam	modo
quoi	il que les bon le je nous de la faire on se consiste
quoins	and of are at
quoique	je la
quoits	and
quolibet	anno
quondam	friend friends
quoniam	in non
quonset	hut huts
quoque	et in argument non
quoquo	modo
quorum	of for is to and was in at sensing shall present or pars being requirements call calls necessary nomina requirement unus may on required could unum be omnium has
quorums	of
quos	in ad et non
quot	sunt
quota	of system for to is was and in on restrictions or sampling systems by from would sample that has at as which basis had will allocation rents should limits under with management may share scheme law can set are limit immigrants were samples allocations increases laws assigned increase could arrangements the policy towards tariff period price shares holders restriction levels based shall rights legislation level regulations prices bill regime provisions limitations fixed protection immigrant plan but allotted program agreements being must requirements allocated control among rent per year agreement be
quotable	quotes
quotas	and for of on were are in to or that by have as is would was which from will at had set based can under may with should imposed could among established assigned but has be against must the within allocated
quotation	from marks is of in on and mark above that at to was or by for which as with comes has will may are shows given about system here appears the I can suggests should indicates within we would he illustrates does taken below cited it also refers must just makes seems gives but made itself might could used attributed see out because into occurs a had contains you begins reveals reads when not concerning implies without follows than ends were there
quotations	from are in and of embodied for on that to which were will or have marked is by as with at may given used above I show taken come can about should made the here he cited we it would illustrate indicate appear was below within could might into do omitted out must not noted refer identified see suggest give contained drawn but concerning attributed already without had found than has marks you make also throughout when included
quote	from the a is in it his one brief here an him this on at some them again to that and only as you by for what of two me these or with was another above any marks their her my about below passages Professor prices but Scripture many all extensively more directly further your comes once just Sir verbatim are several such John its also our other examples part Shakespeare freely those I Lord no appears character so three briefly scripture The extracts figures poetry has suggests certain mark can something illustrates which now attributed chapter when will without authorities myself Marx against Mr indicates rates because may instances Aristotle Paul William first material both James shows taken not unquote statistics entire characters excerpts Robert he would out anything Thomas largely words within someone see exactly George almost Miss lines should long
quoted	in by from above as the on at a to here and with earlier for is below are passage or this it him an words material statement passages that was his of one some price phrase extensively before were them against sentence companies verbatim these ibid prices directly lines remark so without several only there letter her more out market language under speech also after text approvingly but example previously supra saying later again elsewhere many figures may will me string two have line which statements article has about throughout matter he what examples when would already remarks Scripture because paragraph definition than work show frequently just company concerning freely all study verse phrases John almost therein part shows says another does provision can both according In infra dictum their upon description case strings do my figure section often paper should where rate comment values had verses we you value not thus within must book sentences Lord Shakespeare herein during those rates liberally word per Sir The texts securities sources poetry once largely portion over statistics expression I most three shares first today entire among observation since seems poem correctly extracts exactly source scripture regarding very other Lenin immediately President studies materials hereafter no refer authors widely further such author authorities comments enough excerpts even cases works its might gives could appears Professor report clause provisions essay something twice letters reference opinion repeatedly either authority back certain too refers maxim instances
quotes	from the a in are and an this with as to him it on one for that at his some or is used two of several around by these extensively them were another approvingly her only about because John many here no passages also what you will Aristotle can Sir other directly three above have come both examples me when I figures part William freely Professor Scripture Jesus may various such Isaiah so himself taken all Paul more The without verbatim lines which Augustine largely numerous Thomas James within Lord out Plato Psalm should illustrate Cicero was
quoth	he the she I Sancho my Don Sir Robin one Panurge a they hee
quotidian	and life reality world existence fever experience
quotidienne	des en de
quotient	of is will and in by for obtained to was as figure or group between rule from can space would has may are digit which with must that on when the at gives should being
quotients	of are and for in were obtained to is
quoting	the from a in at an his this it him some them here and of one as these what to United with Scripture her prices for or that text John two passages their my extensively The directly Wright another Shakespeare any poetry again is Restatement scripture only several me other someone verbatim Sir Aristotle its William figures Lord In on such you all brief Thomas because New himself Isaiah letter Professor something many out those more your authorities examples James various lines Paul Robert Psalm Marx
quovis	modo
quoy	que il
quse	in
quum	in
quy	dinh
qx	and is
