Z	is and of are in to axis Z for as the score A was has will or I value can scores line o with values by on a be direction at The O from J axes z lines would may that which plane had must Magazine i were have E Corporation coordinate coordinates S Zellforsch C et T test elements Naturforsch represents should does Figure into Phys P increases Fig being M directions H D bands electrons Company B c such where could if X Cars s band materials V Physiol CO In Guide transform Zero component we Y but bosons N particles e boson form protons when Zinc material flag Orthop specification also statistic matrix Pflanzenphysiol u disc Kardiol m II components becomes denotes respectively nuclei transformation n then section because R represent U bit logo Med L given denote scale distribution contains did chromosome so Score per said gene state twist between ratio Gastroenterol III disk Anal specifications notation DNA it number This do W To might position stock discs K Scores guide only through than v Anat under equal Total index equals t disks And buffer gives who zero OF Kinderchir x Index variables key type r Ges list Lebensm Q If mass F group times Test factor transition Tierpsychol f ABC there decays organization without indicates co over Axis Gesamte stands system Zone using an order protein variable Klin format virus Angew curve atoms w takes For Compendium Arriving scheme listing after d Notation It dependence Camelopardalis defined series corresponding model units versus isomer requires IV decreases Committee not before Element ion shows along depends means all leads l G Andromedae above Reference Vergl itself one Chir pattern makes class Pola FIGURE Plan table Physik Hautkr As lies organizations even planes instead data sections dziejow p production User each particle subject No provides Value b Ltd conformation about affair Legal isomers ions am row greater
ZA	and is W
ZACHARY	TAYLOR
ZAKON	O
ZAMBOANGA	DEL
ZANE	GREY
ZANLA	and guerrillas forces
ZANU	and PF was in
ZAPU	and was in had
ZB	and is
ZBB	is
ZD	is
ZDV	and
ZE	syndrome
ZEAL	OF FOR
ZEALAND	AND The by New LTD
ZEBRA	BOOKS
ZED	BOOKS Books
ZEITSCHRIFT	FUR
ZEN	AND BUDDHISM
ZENITH	OF
ZENworks	for
ZERO	TO ZERO AND and
ZEROS	TO
ZETA	PROVINCE
ZEUS	Collaboration and
ZF	is and
ZH	and
ZIF	socket
ZINC	AND OXIDE IN Zinc
ZION	CITY
ZIONISM	AND
ZIONIST	ORGANIZATION
ZIP	code Code CODE codes file files Codes PHONE and archive or COUNTRY
ZIPRA	and
ZK	der
ZL	is and
ZODIAC	SIGN
ZODIACAL	LIGHT
ZONE	OF The I A IN AND MANAGEMENT Figure Fig STATE In ZONE
ZONES	OF AND IN The
ZONING	AND ORDINANCE
ZOOLOGICAL	SOCIETY GARDENS PARK
ZOOLOGY	OF AND
ZOOM	command All IN and
ZOOMING	IN
ZORA	NEALE
ZP	and is
ZPD	is
ZQ	is
ZR	and is
ZT	is and
ZUSAMMENFASSUNG	Die
ZZ	Top and Ceti
ZZZZ	Best
Za	and Zhi is Rubezhom
ZaSu	Pitts
Zab	and River is
Zabardast	Khan
Zabarella	and
Zabdiel	Boylston
Zabel	and
Zabern	affair incident
Zabin	and
Zabita	Khan
Zabriskie	Point Gallery and
Zabrotes	subfasciatus
Zabulon	and
Zac	and was said had
Zacapa	and
Zacarias	Moussaoui
Zacatecas	and in to was is on
Zaccaria	and
Zacchaeus	was and is had in stood the
Zaccheus	was and
Zach	and was said had asked to did would could looked is Chandler in took thought knew turned nodded felt has Taylor stood as smiled shook told
Zacharia	von
Zachariae	von
Zachariah	Chandler and was Allen had of the
Zacharias	and was in Werner the had of Frankel is to Ursinus said Janssen Conrad
Zacharie	Astruc
Zachary	Taylor Macaulay and was had Scott said to is Grey Pearce in Boyd Lockman would Cope did of
Zacher	and
Zachman	Framework
Zachos	et
Zachris	Topelius
Zack	and was said had asked to is could did looked would in Bowen Miller has took told turned knew thought Taylor felt nodded Wheat as came went a were stood shook
Zacks	Investment and
Zadar	and
Zadeh	and in
Zadie	Smith
Zadig	was and had to
Zadoc	Kahn
Zadock	Thompson
Zadok	the and was Cramer
Zadokite	Fragments priests priesthood Work Documents Document
Zafar	Khan Ali Marg Hasan Iqbal and Nama was
Zafarullah	Khan
Zafer	Papoura
Zafrulla	Khan
Zafrullah	Khan
Zagal	was to
Zagars	GK
Zagat	Survey
Zaghloul	Pasha
Zaghlul	Pasha and was had
Zagora	and
Zagreb	and in to University was on is for with as Croatia had has the were
Zagros	Mountains mountains and range region mountain
Zagwe	dynasty
Zaha	Hadid
Zahar	Editores
Zaharoff	was had
Zahavi	and
Zahedi	and
Zaheer	and
Zahi	Hawass
Zahid	Hussain
Zahir	Shah al and Baybars was
Zahl	der von und ist in
Zahlen	und der in sind
Zahlenwerte	und
Zahlung	der
Zahm	and
Zahme	Xenien
Zahn	and et in was has
Zahnarztl	Z
Zahra	and was
Zaibatsu	and Dissolution
Zaid	bin and ibn was al
Zaidel	and
Zaidi	and
Zail	Singh
Zain	Khan al
Zainab	and was
Zainal	Abidin
Zainichi	Koreans
Zainul	Abedin
Zaire	and in is to River was has Zambia or had as are for were basin with by Basin from have on the border river that where at would during under of
Zairian	government
Zaitsev	and
Zajac	and
Zajko	AB
Zajonc	and
Zak	and was had said et River
Zaka	Ullah
Zakaria	Haji
Zakariya	Khan
Zakat	is and on of in
Zaken	en
Zakes	Mda
Zakha	Khel
Zakharov	and
Zaki	Yamani and al
Zakim	D
Zakir	Husain Hussain Saheb
Zakka	Khel
Zakkai	and was
Zaklad	Narodowy
Zakon	o
Zakopane	School and in
Zaks	and
Zal	and
Zala	County
Zald	and
Zaldivar	and
Zale	Corporation
Zaleski	and
Zalewski	and
Zaleznik	and
Zalim	Singh Sing
Zaller	and
Zalman	of Shazar Schachter was and Auerbach had
Zalmay	Khalilzad
Zaloga	GP
Zalophus	californianus
Zaltman	and et
Zam	Zam
Zama	in and
Zaman	Shah and Khan was Mirza
Zambales	and Mountains
Zambesi	and River to in river valley Expedition is Valley was Mission at on as the
Zambezi	River and Valley valley river in to was basin is at rivers Expedition Basin from as expedition region
Zambezia	and
Zambia	and in is has to was had as Zimbabwe are for National have the were on or by Daily with from at would where will Airways that which Railway a of African The since Congress can became during Consolidated Railways could Information also Shall Library who should but Zambia today
Zambian	government Government economy copper Copperbelt and border languages Humanism side President society people women children case authorities National
Zambians	and to were are
Zamboanga	City del and Peninsula in to
Zamboni	and
Zambrano	and
Zamecnik	and
Zamenhof	and
Zametki	o
Zametkin	et
Zamfara	State and
Zamindar	of and was or
Zamindari	Abolition system and abolition System of in
Zamindars	and of were in who to or
Zamir	and
Zamora	and was in Vicente had to is y
Zamorano	Club
Zamorin	of and was to had
Zamorins	of
Zamosc	and
Zamyatin	and was
Zan	and said was
Zana	and
Zanarini	et
Zancani	Montuoro
Zanchetti	A
Zand	River and
Zande	and Scheme
Zander	and was Hollander et said had
Zandra	Rhodes
Zandt	and County was to had
Zane	Grey and was had said Gray to asked is Carroll in
Zaner	and
Zanesville	and to
Zanetti	and et
Zang	and Fu Tumb
Zangbo	River
Zangger	Committee
Zangwill	and was in to has had is
Zanichelli	Editore
Zanjani	ED
Zanna	and
Zannad	F
Zannichellia	palustris
Zanobi	di
Zanoni	and
Zanskar	and
Zante	and in to currants
Zantedeschia	aethiopica
Zanthoxylum	americanum
Zanu	PF and
Zanuck	and was had to said
Zanzibar	and in to was is on for had as Town Island has with the were by or from Protectorate coast at are town Government became that a would which Nationalist during he where itself government under revolution of who have Revolution National island
Zanzibaris	and were
Zao	Wou Ren
Zap	the
Zapadnoi	Sibiri
Zapata	and was had Lujan to in County Olivella Off is y as Swamp would himself were et
Zapatista	movement Army uprising National rebellion de Rebellion rebels communities
Zapatistas	and in were have had are to
Zapf	Dingbats Chancery J and
Zaphod	Beeblebrox
Zapiski	o iz
Zapol	WM
Zaporozhian	Cossacks Host Sich
Zapotec	and Indian Indians culture women language of state
Zapotecs	and of
Zapotitan	Valley
Zappa	and was had is
Zapruder	film
Zapus	hudsonius
Zar	und Cult and cult
Zara	and was in had to is said Steiner on has
Zaragoza	and in was to is had on
Zarah	Leander and
Zarate	and Salmeron was
Zarathushtra	and was is himself
Zarathustra	is and was in to has had as himself says the that or
Zarb	GA and
Zarcillos	Largos
Zarco	and
Zareba	W
Zaremba	and
Zaret	BL and
Zaretsky	and
Zaria	and Province in to was
Zarins	CK B
Zarit	et and
Zarlino	and
Zaroulis	and
Zarqawi	and was
Zartman	and
Zarya	and Vostoka
Zarys	historii
Zaslavsky	and
Zasloff	and
Zastrow	and
Zastrozzi	and
Zasu	Pitts
Zasulich	and
Zat	is and
Zauber	AG
Zauberflote	and
Zavala	County and was said had y to
Zavod	za
Zavodskaya	Lab Laboratoriya
Zawadzki	M
Zawahiri	and was
Zawi	Chemi
Zax	and
Zay	Jeffries
Zayas	and y was Enriquez
Zayd	ibn al and is was
Zayed	bin
Zayn	al
Zaynab	and al was bint
Zaza	and
Zazen	is
Zazie	dans
Zbigniew	Brzezinski Herbert Bujak
Zbirka	sudskih
Zbornik	radova za
Zborowski	and
Zc	is and
Zcitschrift	fur
Zdeblick	TA
Zdenek	Fierlinger Mlynar Cervenka Nejedly
Zdenko	Antic
Zdzislaw	Najder
Ze	is and Xie Dong
Zea	mays Mays and Bermudez mais diploperennis Mais
Zeal	for and of in to is without was against
Zealand	and in is to was Journal has as are for Government had the Company by were or have with on at from Division Herald Penguin would Institute government that Maori of Ltd a where will English Association should Army troops Society which First society flax during waters Law Department it who Parliament there than could but Council white can also Limited The Labour National Medical Air species Ministry may economy Act Forest Shipping law Norway White University women history under dollar before New Official when he did since became House Dairy after spinach shall Court we Gazette I coast forces case Bill experience Constitution Listener Brigade public must High Prime butter region Book literature they Wars Banking Navy children into Railways might politics life governments Geological citizens system Times Expeditionary Australia citizen Mounted Literature until Rugby Library does Post if Maoris about Land because Geographer market Bank ports United tax Antarctic Corps trade company over Defence lamb College now study population Film Biography Broadcasting through dairy soldiers dollars team currency without context Women schools took Federation rugby companies birds International Random Verse made Closer Parliamentary only being Nicaragua between conditions Alps Insurance began legislation Te Loan Inst Public this writers South all Trade Stock Treasury courts writer Standard Police Education In came ship exports itself people farmers today War authorities journal Flax wool industry model A Politics Business sheep Tourism Embassy flora rabbits do Archaeological plants Governments chief universities Experience Infantry one national Conference culture an State Flora mice Planning Press forest landscape not political poetry education Black Poetry Libraries alone resident Tel Canada so Minister soils land division Studies Meat General delegation Geographical Jour Agreement within film fur meat art still v cities Superannuation black bush poet History Veterinary area citizenship business Food representative forests policy newspapers Foundation against found fisheries some Amendment School Forces group officials Naval Economic Environment Meteorological men writing school no Foreign university produce infantry mutton Wool war Universities tour residents farmer Customs sent Health television data wine administration more Educational native family Spinach hemp via Steel Birds press islands social Party ships bird chiefs court students Dental while followed Bulletin Economy Abstract again All be Church gave Nigeria accent police Oceanographic woman military Social Med lies state seems any provides adopted Historic parliament Alpine fiction remained labour Soil soil firms products J Chambers consists Electricity scene agreed provided stories soldier rivers Qualifications Art fauna showed having Population standards agriculture cricket approach Cross Settlements party This born Immigration Mission Fruitgrowers too continued sea Tourist cases affairs To research both flag community artists officers Thomson representatives Forestry Census manufacturers Contents Curriculum Literary scheme teachers joined see fishing coastal towns speech Grassland received Citizenship Farmers Japan Phone identity Auckland Academy together
Zealander	who and is in of to was
Zealanders	and were are had have in who to of at as on would from with that was will is do
Zealot	movement and party
Zealots	and were of in who had to for
Zealous	for and in to as
Zeaman	and
Zeami	and Motokiyo was
Zeb	and was had said Vance
Zebah	and
Zebedee	and was in is
Zebehr	Pasha
Zebina	Eastman
Zebra	Books and Finches Finch mussels Mussel is Historical Press mussel Mussels finch National
Zebras	are and Do
Zebrina	pendula
Zebu	cattle and
Zebulon	Pike Montgomery Butler Vance and Baird Brockway
Zebulun	and
Zecca	dello
Zech	and
Zecharia	Sitchin
Zechariah	and Chafee was is the in had to as are has said that saw says were son also Frankel ix xiv
Zechmeister	and
Zechstein	salt Sea and of
Zeckhauser	and
Zed	Books Press and was had
Zedekiah	was and to the had king in is
Zedillo	administration Ponce and was
Zedong	Thought and in was had to thought as on ji sixiang himself said is junshi
Zee	and was TV Bridge to DS et had in is Zee said
Zeeb	Road Rd
Zeebrugge	and in on
Zeeland	and in to Chamber was were had
Zeeman	effect splitting energy Effect and effects interaction levels components term sublevels pattern splittings patterns shift background triplet Hamiltonian
Zeena	had
Zeenat	Mahal
Zeeuw	D
Zeev	Sternhell Maoz Jabotinsky Schiff
Zefiro	torna
Zeger	and
Zehn	Jahre
Zehnder	interferometer modulator International and interferometers Interferometer
Zehr	and
Zeichen	der des und von einer in eines
Zeichner	and
Zeichnung	der von
Zeichnungen	und von des der
Zeid	and was
Zeidler	and
Zeigarnik	effect
Zeiger	and RS
Zeigler	and et
Zeiher	AM
Zeila	and
Zeilschrift	fur
Zeinab	and
Zeir	Anpin
Zeiraphera	diniana
Zeisberger	and was
Zeisel	and
Zeiss	and Jena microscope Ikon Stiftung in binoculars Tessar Optical EM lens Axiovert of works Works optical lenses Company
Zeist	and
Zeisz	and
Zeit	der und des in von zu ist im die vom nach als vor nicht University and bis mit eine noch zwischen auf an ein fur um auch hat war wird is das aus sind zum zur haben bei nur durch ihrer den wurde Jesu sich lang hindurch seiner was of t so ohne
Zeitalter	der des Jesu seiner
Zeitalters	der
Zeiten	und bis der des in
Zeitgeist	of and in is that was or which as has
Zeitgeschichte	in
Zeithaml	and et
Zeitler	E
Zeitlin	and
Zeitpunkt	der des
Zeitraum	von
Zeitscbrift	fur
Zeitschrif	t
Zeitschrifi	fur
Zeitschrifl	fur
Zeitschrift	fur fiir der des fuer filr fUr far fir ftir for f Fur fitr fu flir in und and fttr ftlr fflr zur
Zeitschriften	und
Zeitung	of and in des was on fur for und had published is to that reported wrote has which as from von
Zeitungen	und von
Zejnil	Delalic
Zeke	and was had said is to would did asked could looked in
Zeki	Bey Velidi and
Zelaya	was and had in
Zelazowa	Wola
Zelda	Fitzgerald and was had Sayre said is Fichandler to in would has
Zelditch	and
Zeldovich	and
Zelea	Codreanu
Zelefsky	MJ
Zelenock	GB
Zeleny	and
Zelia	Nuttall
Zelie	de
Zelig	and
Zelikow	and
Zelinsky	and
Zelis	R
Zelkova	serrata
Zell	Miller am and was Publishers in
Zella	Luria and
Zelle	und
Zellen	der und des in mit im von sind
Zeller	and was et in had has is
Zellerbach	Corporation Paper Family
Zellforsch	Mikrosk
Zellforschung	und
Zellig	Harris
Zellner	and
Zellweger	syndrome
Zelman	Cowen
Zelnick	and
Zelnik	and
Zelter	and was
Zem	Zem
Zemah	Duran
Zeman	and Shah Khan RK
Zemaun	Shah
Zembla	and to
Zemin	and in was to has as
Zemindar	of and
Zemindars	and of were in to
Zemire	et
Zemke	and
Zemlia	i
Zemlya	i and in is
Zemon	Davis
Zemski	Sobor
Zemskii	Sobor
Zemsky	Sobor
Zemstvo	and Union statistics of Congress in
Zemstvos	and were
Zemu	Glacier
Zen	Buddhism and master is Buddhist in masters Master Center meditation practice monks sect monk of was Buddhists to tradition monastery has as temple training priest monasteries teacher Masters temples priests school philosophy garden koan experience or teachers Mind for students student teaching that Meditation literature had art saying are Mountain gardens center can with Bones story Flesh at Teaching does practitioners teachings no way thought Sun by Institute from koans Sect centers schools the School enlightenment painting practitioner discipline monastic sects approach texts Nihon would stories Dust mind doctrine arts which Garden Monastic teaches on style life Koan itself there may spirit followers macrobiotic under history patriarch community Practice Classics poet culture a were Studies Community Shiatsu people Monastery Temple Doctrine I will movement man traditions concept poetry it Poems
Zena	and Sutherland was had Smith said
Zenaida	macroura asiatica
Zenaidura	macroura
Zenana	Mission Missionary
Zenas	Leonard Henry and
Zend	Avesta and language is or
Zenda	and
Zeneca	Pharmaceuticals
Zener	diode diodes breakdown voltage cards Diode and effect current Diodes model
Zeng	Guofan and et Qinghong Yi Jing was
Zenger	was case trial and had in to
Zenghis	Khan
Zenia	is
Zenith	Radio and of Electronics Data Distance is distance was angle Angle in to City has had Corporation Press Tube
Zenker	and
Zenko	Suzuki
Zeno	and of was the in had is to at himself as or effect has would on did said were that Gandia Vendler with by taught who says Maggiore are map
Zenobe	Membre
Zenobia	and was is in had of to
Zenon	Trudeau papyri and Pylyshyn Papyri Kliszko
Zentralarchiv	fur
Zentralasiatische	Studien
Zentralbl	Chir Bakteriol Gynakol Neurochir
Zentralblatt	fur fiir der
Zentrale	Stelle fur
Zentrales	Staatsarchiv
Zentralinstitut	fur fiir
Zentralkomitees	der
Zentralmuseums	Mainz
Zentralrat	der
Zentralstelle	fur
Zentralverband	der
Zentralverlag	der
Zentren	der
Zentrum	fur der des fiir und Paul in and
Zenz	and
Zeolite	Science A Conference Molecular Conf
Zeolites	are and in
Zephaniah	and Swift Williams is was the Kingsley
Zephiran	chloride Chloride
Zephirine	Drouhin
Zephyr	and Press was Cove is to had gently in
Zephyrin	Engelhardt
Zephyrinus	and
Zephyrus	and
Zepp	and
Zeppelin	and was raids raid had in Company airship airships to is sheds II at or IV were
Zeppelins	and were had in
Zeppo	Marx
Zerah	Colburn the
Zerbe	and
Zerfall	der des
Zerhouni	EA
Zeri	i
Zerlina	and in
Zermatt	and to in is
Zermelo	and
Zernike	polynomials coefficients moments polynomial theorem equation and
Zero	to and is Population Hour in or Mostel Tolerance was hour Defects fighters tolerance Point of coupon point Coupon fighter Zero order for Order the on Length defects de at population One Sum had time Option as Gravity Energy flag Base The Suppression Degree has Growth degrees with values Emissions suppression Page Waste Emission means sequence indicates Configuration that would Administration growth level said percent Power crossing Time Two Inflation Crossing out field Defect line by if pilots In gravity Interest sum
Zeroing	in In
Zeros	and of in were are to that on had
Zeroth	Law law
Zersetzung	der des
Zerstorung	der des
Zerubbabel	and was the is in as to thou
Zervas	and NT
Zest	of for and
Zeszyty	Naukowe Historyczne
Zeta	Tau Psi Chapter Phi Beta potential and Potential chapter is Alpha Zeta has Acosta Chi was of Eta Province Sigma Kappa in at Delta Jones Aurigae Gamma Reticuli
Zetes	and
Zetetical	Society
Zethus	and
Zetkin	and was
Zetland	and to Islands in
Zettlitz	kaolin
Zeugnis	der des
Zeugnisse	der
Zeuner	diagram
Zeus	and is was in at to the of had himself as or has who on with for by that will from sent Ammon gave would are could does made were sends did took Olympios can may Olympius Soter became then a said must which came but gives when Eleutherios into Polieus Meilichios Herkeios should might he Xenios also turned takes alone punished saw against faber decided temple I be struck Lykaios upon ordered Hypsistos changed his because whose over appears
Zeuxis	and was painted of
Zeuzera	pyrina
Zev	and Radovan
Zeven	Provincien
Zeventiende	Eeuw
Zevi	Hirsch and was in
Zeya	and
Zez	Confrey
Zf	is
Zhabotinskii	reaction
Zhabotinsky	reaction
Zhai	et and
Zhan	and et
Zhang	and et Chunqiao was Yimou Y Jian J Guotao Zuolin Zhidong Xueliang X L had H Qian Jie Zai is Z Wentian Dai Binglin S San Fei W Taiyan Heng Ailing Xianliang Yi Junmai to said Xinxin Wei Aiping Liang Zhen Zhupo M Yu Tianyi in Hua has Zhizhong Yuan for Shenfu Q Lu Li Ji etal Hong Huan Daoling C D Xun family G Jing Xuecheng F Qi also R Zhung Jun Wannian Chengzhi zhung Dongsun Han Yan B P K Zhong Ping Wenjin did of Juzheng Kangkang Daqian Yanyuan Shizhao Xiaogang Ming Zhi Department as would Tailei Shuguang Longxi Ziyi
Zhanlue	yu
Zhao	Ziyang and et was had Mengfu is said Y S in Gao to X J Shuli Yi Renwei of H Kuangyin M
Zhdanov	and was in had
Zhejiang	Province province and University Provincial provinces in renmin
Zhelyu	Zhelev
Zhen	and was Jiu Hu
Zheng	He et and Chenggong Xuan Yi Zhenduo was Qiao Yongnian Guanying W Bijian is J
Zhengxin	Zhu
Zhengzhou	and
Zhenya	and was
Zhi	and Zi Gan Shi Mu was Ke
Zhili	and
Zhirinovsky	and
Zhishi	Chubanshe
Zhitomir	and
Zhivago	and is was in
Zhivkov	and was in had
Zhizn	i
Zhob	and Valley valley
Zhong	and et Yi Guo Kui Yao Shan Lu Hui Rong Hua guo was
Zhonggong	zhongyang dangshi Zhongyang Dangshi
Zhongguo	shehui tongji de Tongji jindai renmin qingnian jingji Shehui gongchandang xiandai dianying nongcun gudai funii shibao renkou wenhua Renmin Jingji Qingnian jiaoyu Gongchandang wenxue caizheng Faxue lidai lishi zhexue Xinwen laodong dangdai Guomindang nongye xiju Nongcun xin waijiao
Zhonghua	shuju renmin Renmin Shuju minguo Minguo
Zhongshan	University Road Lu Park and
Zhongyang	wenxian ribao yanjiuyuan
Zhores	Medvedev
Zhou	Enlai and et dynasty was Yang Dynasty Zuoren period had En Yu to in said is J Dunyi Li Y X as dynasties king kings also H Mi were Sheng times Yi L Daguan did that S li Z Nan of W told for rulers Chen made would M
Zhu	Xi Rongji and et De Yuanzhang was Di Yu had Ling Yingtai is Y J X Ziqing Jiang H Hong Lin said Wen in
Zhuang	Zi Autonomous and Zhou et
Zhuangzi	and is
Zhuge	Liang
Zhuhai	and
Zhujiang	Delta River
Zhukov	and was had to in said is as
Zhukovsky	and was
Zhurnal	Ministerstva Moskovskoi SSSR Prikladnoi
Zi	and is in are was to
Zia	ul and was had regime Pueblo in to has is al government said as did of would also period
Ziad	Abu Jarrah
Ziauddin	Sardar Ahmad
Ziaul	Haq
Ziaur	Rahman
Ziba	and said
Zichron	Yaakov
Zick	Rubin
Zidon	and
Zidovudine	is in
Ziedses	des
Ziegenbalg	and
Ziegfeld	Follies and Theatre was Girl had Theater to
Ziegfield	Follies
Ziegler	and et was had in said to catalysts is has of H EE JL MG D catalyst process for
Ziel	der und des ist dieser and zu einer war
Ziele	und der des
Zielinski	and et
Zielona	Gora
Zielsetzung	der
Ziemba	and
Zienkiewicz	and et
Zierler	RE
Ziesche	S
Ziethen	and
Ziff	Davis and
Zig	Zag Ziglar
Zigeuner	in
Ziggurat	of
Ziggy	Stardust and was Elman said had Marley
Zigler	and et
Zigmond	and
Zigzag	Journeys
Ziircher	Zeitung
Ziiricher	Zeitung
Zik	was and
Zikist	Movement
Zila	Parishad Parishads Panchayat
Zilboorg	and
Zilker	Park
Zill	al and
Zilla	Parishad Parishads Panchayat School
Zillah	Eisenstein Court Judge and of was Courts had
Ziller	and
Zillman	and
Zillmann	and
Zilog	Z
Zilpah	Grant and
Zilpha	Keatley Elaw
Zim	and Israel
Zimbabwe	and African in is was has to are as National have had for were Rhodesia Publishing the by with or from on at ruins would government Ruins will where that Women People The Publications which dollar Government Culture during since can Congress became of International a Independent today after could who culture also but under Zimbabwe News plateau border should Human it Broadcasting Institute may Project Trust dollars must into there
Zimbabwean	government women and economy society independence people troops liberation literature state
Zimbabweans	are in to and who were
Zimbalist	Rosaldo and
Zimbardo	and et
Zimm	plot and model
Zimmer	and Bradley was et in had said has is frame
Zimmerli	Art and
Zimmerman	and et was LE Temperament RA in had of is to has HJ Library said for M Telegram telegram on RD GA note JE Brush TS R TJ HM at
Zimmermann	and telegram et Telegram was to note had in has is M Note of reaction on
Zimmern	and in
Zimmerwald	Left Conference and movement conference
Zimmet	P
Zimri	and
Zimring	and
Zin	and is
Zina	and was had Garrison Pitcher Ordinance is
Zinacantan	Center and
Zinaida	Gippius Fyodorovna Hippius Raikh
Zinberg	and
Zinc	oxide and is deficiency in Oxide chloride sulphate Company sulfate Corporation phosphate has Chloride Zinc sulfide Sulphate sulphide blende dust was white White ore finger Alloys stearate Deficiency may supplementation Copper phosphide or Zn Lead can chromate Sulfate acetate Ores also carbonate The salts ores alloys Insulin as from Deposits Institute content on Ore Blende Iron Research Phosphate Dust hydroxide metal metabolism Alloy Tin Sulphide absorption for fingers Sulfide Metabolism Development concentrations ions Pigments Zirconium Mining compounds Suspension Cadmium supplements by levels peroxide plates coatings to Limited Study silicate concentration
Zinci	oxidi
Zincke	H
Zinder	and
Zinderen	Bakker
Zinedine	Zidane
Zinfandel	and is
Zingiber	officinale officinalis
Zingis	Khan and
Zinjanthropus	boisei and
Zink	and
Zinka	Milanov
Zinkernagel	RM and
Zinn	and et is was has in
Zinner	and
Zinnia	elegans
Zino	Francescatti
Zinoviev	and letter was Letter had in were to as is at from on
Zinreich	SJ
Zinsmeister	AR
Zinsser	and disease
Zintl	and
Zinzendorf	and was in had s himself to
Zion	and Church in is City was National to with shall as of Baptist for will Canyon are Lutheran the has had were on Hospital Gate a movement Tabernacle that Hill from church or which at by would Chapel Mule Christian tradition Methodist be Lodge Park College who should Square Cemetery have must Home Evangelical said Society can may Publishing Dinur Bokser Temple theology I where more could it Association Commonwealth itself congregation United The there do Town above Printing became but when we Congregation into Wacholder people Reformed he churches rejoice
Zionism	and was in is as has to had with of that would from were or which by on for are could a at can became did will the itself but among must have should into came before than because also The may during began does might without within
Zionist	movement Organization Congress leaders and Movement leader Executive Federation organization cause Organisation leadership ideology youth organizations Archives state policy propaganda Commission groups Jews aspirations activity enterprise parties idea activities program entity project enemy political settlement dream Idea group ideal party Emergency Youth circles Congresses Council position in or aims lobby Conference settlers work pioneers history forces who Jewish General immigration thought conspiracy colonization vision congress campaign institutions establishment churches State politics claims programme pressure camp occupation affairs Affairs Association regime movements education efforts influence aggression community goals Society Committee activists ideals solution organisation Actions Party discourse underground demands societies interests society ideas invasion plot claim congresses literature goal left Israel bodies case settlements effort Jew executive plan thinkers world organisations views policies press conference narrative women revolution Socialist activist Review representatives struggle delegation funds sympathies agents plans is American attitude nationalism view point Labor presence labor flag question Occupation historiography thinking objectives sentiment national Ideology Office philosophy to immigrants Revisionist character Revisionists Record friends meeting as diplomacy hopes Policy elements commitment officials ranks members aim ethos theory authorities military body endeavor World conflict orientation perspective spokesmen pioneer religious was of support Left ambitions colonies Political public doctrine meetings land newspaper culture terrorism weekly pioneering concept stance socialist argument Church identity agitation
Zionists	and in were to had who of are have as would was could for did that from or on with at themselves the should also wanted by will is but like do began a believed
Zip	Code code drive disk Phone Coon disks drives Please I and Codes Telephone file codes or Send files Date was Daytime Dear Drive field is Signature State City in it Country the Mail
Zipes	DP and
Zipf	distribution s and
Ziphius	cavirostris
Ziploc	bag bags
Zipper	and
Zippo	lighter lighters Dot Manufacturing and
Zipporah	and was took
Zipser	and
Zira	and
Zircaloy	cladding
Zircon	is and
Zirconium	and is in oxide Zr Alloys silicate Oxide
Zircons	from
Zis	is
Ziska	and
Zita	and was had of
Zitat	aus
Zitate	aus
Zitiert	nach
Zitkala	Sa
Zito	and et
Zittel	and
Ziv	and
Zivia	Lubetkin
Zivilisation	und
Zivnostenska	Banka
Ziya	Gokalp Pasha
Ziyang	and was in
Zizania	aquatica
Zizek	has is and argues
Zizhi	tongjian
Ziziphus	mauritiana jujuba spina
Zizka	and
Zizyphus	jujuba mauritiana nummularia
Zj	is and are
Zk	is
Zl	and is
ZlP	code
Zlateh	the
Zm	is and
Zmiany	w
Zn	and in is deficiency are concentration concentrations content was alloy or alloys to superoxide were from atoms ferrite by deposits uptake system at as diffusion on with for levels SOD ions Ga the contents has can atom ratio Cu deposit may ferrites absorption of have metal into electrode ores ore than per which
ZnO	and films is film thin in nanowires nanorods layer
ZnS	and is in
ZnSe	and
ZnTe	and
Znaniecki	in
Zo	is and
ZoBell	and
Zoan	Andrea in
Zoar	and was
Zoarces	viviparus
Zoas	and
Zoback	and
Zobeir	Pasha
Zobel	and et de
Zocalo	and
Zodiac	and is of in was sign are signs to Sign as had with Killer were which
Zodiacal	Light light signs sign Signs Sign
Zoe	and was had said Akins is to Baird could asked did would looked in Caldwell thought has felt took as knew turned says went were with came sat nodded smiled told Dominic shook a the that stood Wicomb at for gave saw Lofgren
Zoete	Wedd and
Zoetrope	Studios
Zoey	said was and had
Zoffany	and
Zofia	and
Zog	and was I had of
Zogby	International poll
Zohar	and is was in I III as II to Hadash that says on et the J has
Zohary	and
Zoji	La
Zola	and was had in is to has as wrote himself or would did et the of for on trial at said could with were who Budd that published a does are describes by
Zoledronic	acid
Zoller	and
Zollicoffer	was
Zollinger	and RM
ZollingerEllison	syndrome
Zollner	and
Zollschan	and
Zollverein	and was in or had of
Zolnierz	Wolnosci
Zoloft	and
Zolotoe	Runo
Zoltan	Kodaly Korda Tildy and Haraszti was had
Zomba	and
Zombies	are
Zon	and
Zona	Gale Rosa pellucida de Norte Franca glomerulosa Libre fasciculata reticularis Sul da incerta Sparks Pellucida Hotelera del Sur Dorada
Zonal	Council Councils Railways and Office Railway distribution Commissioner structure soils
Zonaras	and
Zonas	de
Zonation	of in and
Zondek	test and
Zondervan	Publishing Bible Corporation Pictorial
ZondervanPublishingHouse	Grand
Zone	of and in is Management I A II Books was to III B The C for IV as Research are Act on or System by at with has D V were from the had which VI that Zone where would Treaty Map will between shall State have electrophoresis In Authority This E a Conservation VII Electrophoresis during de Manager Diet refining One under Color Melting may can des Three Government but into VIII F should Figure Two der Information Model melting Four system Development property Tower Commander Transfers diet G there Name Type episode could l Refining Therapy Time Res within after without Plate Number near area government it also police i itself than until X authorities Wizard Code Franc includes around Total along Program Five H Area when Office Fig boundary IX who because must through only Plan Defense Center N before became File Ordinance Committee one Labs Routing
Zoned	Bichrome
Zones	of and in Act are The for A I were to with on II or B as In have is Three Board by III at that C where was
Zong	and
Zongli	Yamen
Zoning	Board and Ordinance Bd Appeals Hearing Commission is ordinances laws in of Enabling Law regulations for Adjustment Ordinances Administrator Resolution Regulations Map Laws Act Code Com Plan Digest District Officer restrictions Committee Game The has ordinance was to by Districts can Administration Zoning as
Zonocerus	variegatus
Zonotrichia	leucophrys albicollis capensis
Zonta	International Club
Zonula	occludens
Zoo	and in Story is was to Yearbook has for at Biology on with had by Atlanta Animals of or The Station animals Biol are as TV were Wildl Veterinarians station Park that where Vet a Lake from
Zoogeography	of and
Zoogloea	ramigera
Zook	and was
Zool	Soc
Zoologica	di Fennica Scripta
Zoologicae	Japonenses
Zoological	Society Gardens Park Museum Garden Institute Nomenclature Station Survey Journal and Record Laboratory Parks Department gardens Philosophy Mythology Studies Congress Research Collection Science Results Societies Researches Sciences
Zoologicheskii	Zhurnal
Zoologici	Fennici
Zoologico	Italiano
Zoologie	et und
Zoologique	de
Zoologisch	Museum
Zoologische	Jahrbucher Garten Jahrbiicher
Zoologischen	Museum Gesellschaft
Zoologischer	Anzeiger Garten
Zoologisches	Institut Museum
Zoologisk	Museum
Zoologist	for
Zoologists	have and
Zoology	and of at in Department University is for from was Institute by has as to The or
Zoom	in tool In Out to and button Extents out box command lenses Control dialog Window All lens slider Tool Lens into control feature window list To Previous on setting option is the toolbar Level menu Lenses drop tools
Zooming	in In and
Zooplankton	and in of biomass are
Zoos	and are
Zoospores	are
Zoot	Suit Sims Suits suit
Zootermopsis	angusticollis
Zopa	Rinpoche
Zophar	the
Zoppo	GJ
Zor	and
Zora	Neale was Hurston and had Neal is Arkus in
Zorach	case and
Zorah	and
Zoran	Djindjic
Zorawar	Singh
Zorba	the
Zorin	and
Zorn	and was
Zoroaster	and was is in himself had to as or the taught lived were of has
Zoroastrian	religion faith and priests community tradition doctrine scriptures dualism fire religious influence texts belief literature or system priest ideas Religion theology
Zoroastrianism	and was is in as of had to has the
Zoroastrians	and in of were who are to have
Zorrilla	de and
Zorro	and was
Zoryan	Institute
Zorzi	had was and
Zosa	Szajkowski
Zoser	and
Zoshchenko	and was
Zosia	and was
Zosima	and in
Zosimus	and is was of
Zoster	Virus is
Zostera	marina and noltii beds
Zosterops	lateralis
Zou	and et Rong Jiahua Taofen Yan
Zouave	uniform regiment Cadets jacket
Zouaves	and were in of had
Zouch	and in
Zouche	of and
Zoutpansberg	and
Zoya	was Hasan and had
Zoysia	japonica
Zp	is and
Zq	is
Zr	and is in alloys alloy are content or atoms to system
Zs	is and are
Zsa	Zsa Gabor
Zsigmond	Moricz
Zsigmondy	and
Zt	is and
Zu	den diesem einer dem dieser einem der einigen diesen Beginn and San Rhein is seinem Artikel
Zubair	and was
Zubayr	and
Zubdat	al
Zubeir	Pasha
Zuber	and et
Zubin	Mehta and
Zubok	and
Zubovsky	Boulevard
Zucchi	and
Zucchini	and with Bread Soup
Zucht	und
Zucker	and rats et rat und
Zuckerkandl	and
Zuckerman	and et was is has Unbound in had JD AJ Bound to
Zuelzer	and
Zuercher	Zeitung
Zufii	Indians and
Zufuhr	von
Zug	and der in nach
Zugabe	von
Zugang	zu zum zur
Zuge	der des
Zugleich	ein
Zugriff	auf
Zuid	Afrikaan Holland Afrika Afrikaansche
Zuidelijke	Nederlanden
Zuidema	GD
Zuider	Zee
Zuikaku	and
Zuingle	and
Zuinglius	and
Zuiver	Wetenschappelijk
Zuk	and
Zukin	and
Zukofsky	and was had
Zukor	and was had
Zukunft	der des in und zu
Zuleika	Dobson and
Zulfikar	Ali Khan Ghose
Zulfiqar	Ali Khan
Zulia	and
Zulma	Carraud
Zuloaga	and
Zulu	War and king army nation people war kingdom chief King in warriors language of country was is Nation or society women to warrior Kingdom were tribe had power state culture word kings who chiefs royal military as history wars Rebellion name woman for force men attack leader Country impi Wars impis Chief rebellion tribes are Mission regiments People territory custom empire Aftermath Natal with Sofola time at tradition children girl from clan would man boy kraal has by life border armies forces Kaffirs land Empire invasion the chieftain nationalism girls on monarch religion origin
Zululand	and in was to is with as by had were at on from for the
Zulus	and were in had are who to of at have as would on was or from under with that could for
Zum	Problem Verhaltnis Beispiel Begriff einen anderen ewigen ersten Verstandnis Stand Felde Vergleich Thema Schluss Wandel Teil Ursprung Gebrauch Einfluss
Zuma	Beach and was
Zumarraga	and was
Zumbro	River
Zumwalt	and was
Zunahme	der des von
Zundel	and
Zung	Self Depression
Zuni	Indians and Pueblo in Indian people Mountains is River to pueblo culture are of pueblos area was Mythology Reservation region villages Folk tribe Ceremonialism or have were language pottery by Salt as the Polychrome Creation Tribe women Man life
Zuniga	and WR y was to
Zunis	and were
Zuntz	and
Zunyi	Conference
Zunz	and was
Zuo	zhuan Zongtang and Commentary Zhuan
Zuordnung	der von
Zuppa	di
Zur	Geschichte Frage Kenntnis Theorie Kritik Entwicklung Lehre Kenntniss Entstehung Psychologie Problematik Bedeutung Morphologie Soziologie Entwicklungsgeschichte Anatomie Vorgeschichte Analyse Bestimmung Physiologie Rolle Biologie Struktur Zeit Deutung Lage Genealogie politischen Pathologie Funktion Logik Behandlung vergleichenden Methodik Theologie Sozialgeschichte Klinik Interpretation Entstehungsgeschichte Genese Chronologie Datierung deutschen Erinnerung Rekonstruktion Pathogenese Situation Sache Beurteilung Technik Diskussion Grundlegung Rezeption Judenfrage Systematik Berechnung Aetiologie Stellung Genesis Gesch Phanomenologie Diagnose Herkunft Wirkung Geologie Farbenlehre Charakteristik Literatur historischen Verbreitung Sprache Untersuchung Okologie sozialen Dynamik Psychopathologie Politik Hausen Reform Darstellung Typologie Quantentheorie Entwickelungsgeschichte pathologischen Anwendung Semantik Philosophie Erklarung Chemie Methode Atiologie Naturgeschichte Einfuhrung Psychologic Morphologic Dialektik Volkskunde Messung Therapie frage Biographie Mechanik Elektrodynamik neueren and Statistik Ikonographie Erforschung Topographie allgemeinen Geochemie Bildung operativen Syntax Auffassung Komposition Auslegung Ermittlung Nedden Histologie Seinsfrage Histologic Psychoanalyse
Zurbaran	and was
Zurcher	Zeitung and
Zurich	and in to was on for is Letters with had University as the or by at Switzerland from were he has that where Insurance during I Polytechnic are a Research school Ins of Dada und airport group Congress who Bible School when Financial which General under Tel The after would have Schauspielhaus before Agreement Zurich there city Opera but Council Airport we bank Stock speech itself Kunsthaus
Zuricher	Zeitung
Zurilla	and
Zurn	Industries
Zusammen	mit
Zusammenarbeit	mit zwischen der in und von im auf
Zusammenbruch	der des
Zusammenfassend	kann
Zusammenfassung	der Die und Es In Der
Zusammenhang	mit zwischen der von ist des zu gebracht stehen damit die steht nicht und
Zusammenhange	zwischen mit
Zusammensetzung	der des und von
Zusammenspiel	von
Zusammenstellung	der von
Zusammenwirken	von
Zusatz	von
Zuspan	FP
Zustand	der des und in
Zustande	der und in
Zustandekommen	der
Zustandes	der
Zustimmung	des der zu
Zutphen	and in
Zutty	Singleton
Zuyder	Zee
Zuylen	van
Zuzana	Licko
Zvai	Leumi
Zvelebil	and
Zvezda	and
Zvi	Griliches and Gitelman Institute Hirsch Yehuda Greenberg was Bodie Lerman Yehudah
Zviad	Gamsakhurdia
Zwaan	and et
Zwang	zur
Zwanzig	Jahre
Zwanziger	Jahre
Zwar	ist
Zwart	and
Zweck	der des und im
Zwecke	der des
Zwei	Jahre neue Falle
Zweifach	BW
Zweifel	an and daran
Zweig	and was in der had to has wrote et is
Zweige	der
Zweigenhaft	and
Zweigert	and
Zweite	Auflage Weltkrieg Abteilung
Zweiten	Weltkrieg Weltkrieges Weltkriegs
Zweiter	Teil Band Theil
Zweites	Buch Deutsches
Zwemmer	Gallery
Zwi	Werblowsky Migdal
Zwick	and
Zwickau	prophets and in Prophets
Zwicker	and
Zwicky	and
Zwieten	PA
Zwillich	CW
Zwinderman	AH
Zwingle	and was had
Zwingli	and was had in to himself at on is Verlag as und did the were that or
Zwinglian	and view doctrine Reformation
Zwinglians	and
Zwischen	den dem der Himmel zwei diesen
Zwolle	and in
Zworykin	and
Zx	and is
Zycie	Warszawy Gospodarcze Literackie
Zydow	w
Zydowskiego	Instytutu
Zygmunt	Bauman August III Krasinski and I
Zygomatic	arch bone process Arch nerve
Zygomaticus	major minor
Zygosaccharomyces	rouxii
Zygote	intrafallopian
Zyklon	B
Zyl	Slabbert and Smit
Zymogen	granules
Zymomonas	mobilis
Zymotic	Diseases diseases
Zysman	and
Zyuganov	and
z	is and axis direction in are z o of score to plane value scores for the values directions as axes component from a I can with The coordinate at be will i or e by coordinates components which has on that test transform O A may such Z vols s must was Figure c being Fig we where CO u statistic distribution m above In y only would increases represents transformation S respectively along have n into E between when sound per This lat but denote denotes if were dnia does parameters D represent ratio r t should nich range co H inches below so position equal w it becomes It then dependence X given gives corresponding P See M p planes x C transforms cup d V units scale tym approaches years through tego over equals T varies For within roku dn zakresu Scores lies hours domain gene there Zero B under could times because inch miles not LU N an dimension depends As percent alone en table variables instead also ratios curve teaspoon okresu We using G cups variable tych f changes before II distance according feet g Polski after J million FIGURE corresponds k than had let system Element If U one do b dziejow option form space Zinc To this indicates Score punktu h Q due defined zero constant But yields all decreases v Test sounds he
za	and is t in to Statistiku statistiku rubezhom rok istoriju was narodni pomoca of mir a
zag	course lines line pattern path and fashion of or in manner road stitch form patterns direction to paths motion chains up through
zagged	through across
zagging	through across
zags	of and in
zai	Zhongguo
zaibatsu	and were families firms groups in banks was dissolution had
zakat	is and on to of in was
zakonov	Rossiiskoi
zal	de worden het zijn
zamindar	of and was or in to had who is family
zamindari	system abolition and of rights areas in was estates
zamindars	and of were in who to or had as was are have for
zaniness	of
zany	and antics
zap	the it them you of him a your me
zapatos	de
zapped	by the with him me her
zapping	the
zaps	the
zar	cult is and
zat	ion i and I is you
zati	on
zation	of and in is to that was for
zations	and
zavod	za
zazen	is and in practice
zc	is
zd	ed of
ze	and is of in zleceniem the w to same
zea	and larvae
zeal	for and of to in with which was that as against is than or on he by the had has into they at would I were may will without could among displayed but are did so can might from not have led should upon towards you we about when a shown worthy made must be she during it nor manifested carried more does even never all toward often inspired his after no rather alone like too over soon beyond seems both hath until if only within outran seemed became sometimes enough according brought there equal because began took also Of found shall through under now gave To their went before throughout this increased
zeale	to and of
zealot	for who of in and to or was is with
zealotry	of and in
zealots	of who and in for to were are had on have as like from or would fight with among that at whose
zealous	in and for to of advocate friend than efforts advocates as friends supporters supporter Christian a Catholic men missionary about defender support young Protestant partisans members member attachment co man against defenders adherents Protestants missionaries Christians exertions promoter partisan champion devotion but care Catholics or preacher advocacy followers officer priest servant reformer pursuit reformers adherent on patriot student attention Roman disciple worker preachers champions endeavours desire Whig interest promoters disciples priests minister effort patriots opponent patron service enough that workers was servants work activity ministers churchmen people persons labours convert spirit an pastor opponents among follower representation discharge services Presbyterian part religious churchman admirers were love assistance labors officers party royalist Whigs opposition cooperation anti students Puritan concern study application attempts converts officials apostle bishop royalists therefore admirer regard partizans one protector guardian manner protestant agent partizan republican patrons professors affection with Presbyterians the teacher votaries protection performance he official defense collector faith Jews believers devotees agents protestants adherence person attempt commitment aid believer brethren papist guardians loyalty prelate local police preaching enthusiasm clergy leaders search teachers citizens they persecutor Calvinist catholic defence assertor clergyman at lover pastors citizen prosecution piety republicans patriotism endeavors public use Puritans individuals catholics Papist apostles upholder son monk devotee Lutheran antiquary ones Jew determination Tory worshippers clergymen Buddhist Churchmen monks Tories
zealously	to and guarded in for as attached supported devoted than engaged the promoted defended pursued into opposed affected maintained with sought guard advocated cultivated protected at on that by against carried espoused employed studied he seconded co embraced guarding did contended prosecuted followed propagated within assisted served preserved urged endeavoured performed applied set preached kept they adopted exerted laboured inculcated enforced upon labored aided guards
zealousness	of in and to
zearalenone	and in
zeatin	riboside and
zeaxanthin	and
zebra	and mussels mussel finches finch is stripes fish crossing in or skin was crossings are to with has that were on of skins
zebrafish	embryos embryo and
zebras	and are in were have
zebu	cattle and
zed	by in and to
zehn	Jahren Jahre
zeichnen	sich
zeichnet	sich
zeigen	die sich eine sie und in auch
zeigt	sich die eine das den ein einen der uns in auch es aber er auf deutlich an
zeigte	sich die
zeigten	sich die
zein	and is genes
zeir	of
zeitgeist	of
zeitlich	und
zeitlichen	Verlauf
zeitschrift	fur
zele	pour et
zemindar	of and to or was in is
zemindars	and of were in to or are
zemindary	of
zemnoi	kory
zemskii	sobor
zemsky	sobor
zemstvo	and assemblies institutions men assembly congress board movement was
zemstvos	and were in to
zen	of and
zenana	and of
zener	diode diodes voltage current breakdown is regulator
zenith	of in angle distance and distances angles at to with is during when as under was the telescope or sector on by from point for passage between sky it about direction than tube a like are star stars before over that delay
zeniths	of
zens	of
zentrale	Rolle
zentralen	Orte
zeolite	is and catalysts A Y framework crystals in with structure catalyst was facies to minerals structures synthesis pores X lattice or crystal has are process ZSM membranes softening bed can surface as at softener for samples channels by water
zeolites	and are in with is have were as can of or by to for has was which may such
zephyr	of that and to blows
zephyrs	of and that blow
zerbrochene	Krug
zero	and in at to or for point is of as when if value mean on the by order time temperature because with tolerance level line values frequency field pressure otherwise hour position velocity potential degrees but coupon sum net only are energy since growth population current mark after crossing temperatures rate elements weather probability voltage gravity so defects initial percent before points correlation degree charge over concentration crossings output bias was from means during phase error volts balance except resistance will slope can cost interest power outside up stress magnetic profit everywhere angle shear vector indicates reading inflation we economic length then while option price would load sequence reference flow that mass state speed within again under through unless marginal element has profits until risk which entries matrix it intensity even input zero basis thickness volume moment bracket amplitude a there lift coefficients may out gives per along discharge between without applied displacement elsewhere base weight Fahrenheit flag due average drift offset salvage spin total angular axis relative rest signal The delay momentum income where deflection coefficient one eigenvalues suppression tax external end throughout strain all electric dispersion setting hours acceleration visibility eigenvalue does curvature intercept levels adjustment real density should distance must than components flux solution yields effect air result tillage bits width force shift being modes near anaphora transaction difference were units incidence times whenever represents impedance also emissions score normal emission expected magnitude rating set change kinetic excess entropy balances bit mode steady surface according form dose dollars variance defect correlations control results scores response elasticity meridian approximation heat component grade rates terms into beat size return inside gate chance range radius loss resultant this rated lag number expectation entry plus plot wind feet below cross corresponds article gradient day residual contribution ionic internal lines errors locations ohms indicating tariffs tariff torque layer inventory sound diagram contact here waste instead have occurs above nor just condition rather age date implies configuration duration cold measure cancellation damping about plane covariance grid term baseline constant knowledge decimal could path impact based prior asymptotically area vertical amount slack group de copula digit no pitch elevation sign viscosity standard gain rotation pattern equals days g pollution function page using discount water divergence strength each dipole indicate activity positions centigrade depth costs both capital years beyond A rows more restrictions method boundary first gap height padding regardless transmission byte absolute earnings tension opportunity frequencies production cash quantity readings morpheme once five count two bytes initially appears porosity grazing simultaneously bending absorbance investment unemployment weights every digits loadings yield NPV space diagonal dynamics off exponentially row phonon immediately clearance four such root counts observations insertion I dimensions contour had wave altitude exit three data cells seconds information symbol sales capacity electrical differential effective year wait thermal circle nuclear extension vectors faster not across cell axial very In around orbital determinant probabilities work background gas threshold horizontal ending right differences slip Centigrade leads eight fill prices bound filling eccentricity utility transfer respectively column consumption resistivity index demand depending spatial radial alternations coverage factor remainder location forms lateral minutes deviation substitution interaction friction upon be marking exposure subscript marks down case separation lower correction scattering conditions starting pair whereas denotes roots too volt electron absorption This exponent nominal oxygen conductivity integer motion Figure nine graduation product dimensional limit trade forward derivative longitude wage fuel source effort dimension overlap dB thereafter code stability duty mortality hardness carbon upwards they suffix trip thrust refers disparity Doppler quantum pairs transactions leakage seven decibels miles either status minus coupling six debt declination an loading taxes second causes class cosmological reflection minimum inches scale added like transition polynomial beta corresponding representing free rapidly lead noise positive origin relationship curve activation ordinate reaction twice following provided divisors derivation almost matrices particle sensitivity reactance compensation money G hypothesis allomorph shows terminal toward against feedback long payoff valence vorticity interval mobility productivity optical datum combinations columns excitation magnetization market solutions Fig If reject transport division expression body deficit dc increase characters transverse you system becomes inclination tangential might moments any sample moisture stiffness although test returns polarization makes experience attenuation divided Kelvin responses pronoun drain rent db among cases section now do variables numbers lot valent subject equilibrium trace rise valued budget x period K pronouns plate dead conversion C divisor together vacuum losses oxidation winter failures towards N gauge produces adjust distortion DC storage sets percentage social address coupons shadow draft he light expansion filled variation Fahr argument immigration autocorrelation
zerocoupon	bonds bond
zeroed	in out and at on
zeroes	in and of are to on for at or
zeroing	in the of out
zeropoint	energy
zeros	of in and are to at on for is or as after that can will with elsewhere from may if by must have between which were into when except the before occur so would do everywhere should only outside following
zerosum	game games
zeroth	order law approximation and moment
zest	for and to of in that with into which as from than the is or was by he on had To when at I out they
zestful	and
zestiende	eeuw
zeta	potential function potentials basis functions
zeugt	von
zeventiende	eeuw
zey	are
zgodnie	z
zh	measure in vision
zhanzheng	shiqi
zhes	bya
zhi	lu and yanjiu
zhizni	i
zhong	de
zhongguo	de
zhongyang	dangxiao
zi	and is in are to
zich	in op niet
zidovudine	and therapy in treatment for or is to
ziehen	und
zieht	sich die es uns
ziem	polskich
ziemiach	polskich
ziemlich	gut stark genau
zien	dat
zig	zag and zags
zigged	and
zigging	and
ziggurat	of was at and in
ziggurats	of and
zigs	and
zigzag	course lines line pattern path and of stitch fashion or in road patterns paths direction manner through to form up across lightning route motion way on trail down shape band flight movement is from design chains bands chain with arrangement back stitches track between movements ornament as the stitching along around over courses at conformation structure dance appearance edges incision moulding markings trenches mouldings folds
zigzagged	through across up down in back from to and between along around over
zigzagging	through across up down in and from to back between along around at over of as
zigzags	and of in up to on through down across are or from between
zij	de het in
zijn	de van in voor er en op om met tijd dan geweest aan niet eigen werk bij dat leven het
zila	parishad parishads
ziliao	huibian xuanji xuanbian
zilla	parishad parishads
zillah	judge and or
zillion	times years dollars other
zillions	of
zillionth	time
zin	van
zinc	and oxide in is chloride sulphate or deficiency to are plate sulphide sulfate dust finger blende sulfide from content ores ore was phosphate ions with alloys as by plates on levels may deposits has for of white insulin can ion coating salts alloy will acetate electrode at concentrations concentration metal supplementation carbonate were salt which mines ointment hydroxide atoms absorption chromate fingers solution have status concentrates stearate into mine atom rod coatings powder production per compounds intake the silicate should than being smelting phosphide that supplements mining bath oxid roof ferrite suspension plating surface amalgam be metabolism die industry smelter concentrate deficient anode deposit would vapor binding pole cell uptake smelters used superoxide dissolves minerals nitrate must strip therapy iodide dissolved bar batteries cylinder contents had sheets selenide cyanide coated gluconate a level when works sheet electrodes oxides present chlorid wire cells shavings complex does anodes paste deficiencies plant roofs also battery produced it but peroxide bromide vapour protoporphyrin compound containing base through during excretion toxicity could boxes etching yellow tub system end borate becomes depletion sulphides mineralization ammonium layer district alone ferrites uranyl pyrithione lozenges values complexes upon supplement added box counter consumed plated forms under crystals solutions group poisoning cement availability etchings process intakes remains over cadmium container tube element particles corrosion requirements products ferrocyanide daily contained strips polycarboxylate goes itself sulfides distillation loss single occurs ratio filings paint increases rich immersed roofing lotion after treatment only baths recovery foil extraction requirement surfaces balance couple diffusion appears nutrition plants The precipitation case gives refinery fumes between acts reacts consumption citrate producers rods so supply prices form fume refining disc instead might oxyphosphate tolerance deposition found enzymes lactate reduction oxideeugenol include do until contains placed side output nutriture bacitracin takes cream pigments cup metalloenzymes
zincblende	structure and
zincs	are
zine	and is for of
zines	and are
zing	of to the and in
zinged	through
zinging	through
zinnias	and in are
zip	code codes or up file and of through to it in files the around on fastener down by into guns along past fasteners back drive lock gun his disk is out over line across from them right your her off archive about disks my
zipless	fuck
ziplock	bag bags
zipped	up it the through his past into by her and around down in out file along open across back over to them off my files right
zipper	of and on down in foot is to was bag up tape or that at motif opening teeth with pull protein open clause as jacket proteins tab for domain
zippered	pocket bag plastic compartment pockets jacket
zippers	and are on in or to that
zipping	up around through along his by past and the it down across in her back
zips	up and through
zircon	and is ages grains in crystals are from age U dating sand with or geochronology data
zirconate	titanate
zirconia	and is ceramics in particles with are ceramic pendant was
zirconium	and oxide is in alloys dioxide phosphate alloy silicate are or metal hydride tetrachloride carbide to with from compounds by was minerals as chloride salts hydroxide content has fluoride can at
zircons	from in are and of were
zirconyl	chloride
zit	on
zither	and with music player is in or
zithers	and
zitiert	nach
zits	and
zj	is and
zk	is
zl	and
zloty	in and was for per a to
zlotys	in per for and a to
zm	is and in
zmian	w
zmiany	w
zn	is and
znakovym	sistemam
znamenem	marksizma
znanosti	i
znd	ed
zo	is and to
zoals	de die het
zoarium	is
zocalo	and
zodiac	and is of sign signs in are was to into as were which with on at that circle or from for the has constellations
zodiacal	light signs sign constellations constellation cloud circle dust stars band belt and
zoeal	stages stage
zoek	naar
zog	sich er
zoisite	and
zoledronic	acid
zolpidem	and
zombie	and is in or state to who
zombies	and are in who were to of or
zona	pellucida glomerulosa fasciculata reticularis de incerta di radiata del compacta is and reaction drilling dissection da binding intermedia reticulata
zonae	pellucidae
zonal	wind and mean flow distribution structure winds centrifugation circulation harmonics soils boundaries arrangement pattern velocity system or component level harmonic index average rotor part current wavenumber boundary offices soil momentum scheme basis wave direction rotors flows prices range division councils model currents necrosis averages anatomy spherical development office patterns border restrictions growth vegetation method motion type approach railways westerlies differences types variations divisions pressure character kinetic trade
zonality	of in is
zonally	averaged symmetric
zonas	de rurales
zonation	of in and is patterns on for pattern was with from has scheme
zonations	of
zonder	dat
zone	of is and in to between was for with where are at or that as on which the has from by may can around will were would along management within near should into during had electrophoresis but have boundary a de I A plate under there system must extends B above size than II contains could boundaries extending axis when it The without model about refining below consists III through file also over melting because after containing includes i lies defense does surrounding only being transfers before so itself width becomes appears C just they adjacent transfer shall immediately data length if we temperature while area out beyond occurs plates beneath might until concept files theory information represents due center scheme map shows changes increases you IV Figure number up called behind occupied exists one be formed varies change countries outside thickness forms diameter areas j comprises method consisting against D south north not corresponds radius lying free off Fig depends close separating rather across whose located since name time cells covers became formation having did more all using he begins differences development established remains round species control do structure defined corresponding moves V known now seems usually such passes stretching lymphoma depth therapy some reaches include models type two included created including comprising In indicates ahead sizes temperatures towards covered composed des provides characterized based an du proposal down associated thus lines manager extended this except plan develops even toward like occupies then east who often bordering E soil contained generally axes developed commander made pricing show air level edge throughout next marked three running shown according tolerance results zone probably west database technique plants no spreading diameters covering soils maps commanders systems broadening produced research decreases described alone affected still gives region directly d ranges coverage most again conditions here bounded F defenses inside water situated land showing press dominated requires policy set program produces lesions volume pattern di refined approach makes showed provided forests line began punch remained receives continues This centre increased both tends material caused bits following runs approximately referred planning proper comprised appear residents used compared indicated among limits unless several VI analysis configuration status came coincides comes lengths takes parallel pass location become suggests classification controlled processes numbers contiguous too settings means appeared consisted either designation causes relative gradually design G together almost allows starts via settling follows very upon prior wherein separates products subject legislation represented stretches growth employment monitoring agricultural height found crops names franc contain leads field instead widths constitutes designated differs rocks resulting travel face b lay further protection surrounded mentioned nearest already limit basis rich programs flow property vegetation aride difference first shifts problems followed geometry furnace occur once occurred indicate less per types rates centered similar VII range these inhabited well shape fossils offset X representing managers deposits idea each form lie heating setting portion properties grows encompasses factor samples Z regions environment encompassing five filled business c plus FIGURE forming z resources surrounds agriculture took Zone assigned office much presents arrangement T far ten exhibits its needs need process surface distribution away reserved fruits marks forest statement An concerned VIII every characteristics border adjoining continued disappears serves regime see expands vary academy present S projects reached four regulations faces ends fare effects earthquakes always specified acts nor supports structures activity farther hypothesis falls l required valves non
zoned	for and out as in to with land plagioclase residential decimal areas by area into crystals or commercial the R from editions industrial property
zones	of and in are is were for to with that or where on have as which can may at within between by around from was the will would along into has should de had could such during but under must than based near do A also it I there according so a occur over appear because through being containing without when The surrounding they like shall only established above include adjacent become throughout might exist after show across contain not corresponding defined represent away formed associated we rather described outside having each be due located used shown often below form while separated beyond about extending correspond occupied whose if created all tend before up using did more became vary B II provide developed respectively except lie themselves does extend parallel overlap differ usually you found until humides indicate characterized one produced i generally close rurales together marked identified including called indicated present consist set controlled mentioned off seem already In since develop designated now remain against lying inside ranging north just both affected free beneath running most thus varies covered III C out made still even depends representing need included behind caused represented per provided referred he related immediately this covering make known showing bordering similar showed shows who urbaines probably increases allow comprising subject
zoning	ordinance and ordinances regulations laws of is in board restrictions law or plan to for was map change district changes by regulation code districts as has requirements commission system power codes appeals classification boards decisions enabling authority amendment that can cases practices plans variance scheme may are on administrator powers authorities process maps would the controls rules legislation policies provisions out variances restriction resolution policy decision which with will case officials should amendments problems matters lot permit at issues systems classifications from patterns hearing purposes must does commissions bylaw schemes permits approval standards had officer techniques could were have committee action pattern bylaws administration violations control actions within statutes designation practice be violation measures problem department a category allows statute enforcement litigation provision categories but act under program procedures
zonked	out
zonula	occludens adherens ciliaris
zonulae	occludentes
zonular	fibers cataract fibres
zonule	of is fibers and
zonules	and are
zoo	and in animals is or of was to with for at has on that animal keeper where had as director are visitors keepers were the staff would when a will can by I which from grounds directors exhibits but also officials entrance there
zoobenthos	in
zooecia	are in and of
zooecial	walls wall
zoogeographic	regions
zoogeographical	regions region
zoogeography	of and
zooid	is of
zooids	are of in and
zoological	gardens garden and specimens park collections classification parks nomenclature collection species science research studies scale work knowledge or museum provinces literature works position characters point system regions sense groups series station interest study world taxonomy group terms department society evidence province laboratory researches material character sciences name specimen subjects information order
zoologique	de
zoologist	and who of to at in or has would is as with can from
zoologists	and have to of who in as are were that believe
zoology	and at of in is or as to from department was are that with has were for professor which the by have class
zoom	in lens out lenses and to into level factor the is box back up range of tool setting control percentage on or feature down around by through off ratio from shot past levels with settings controls window function effect shots system over magnification button at for a away camera mode capability right
zoomed	in to up out past into off by down from over through back away around and the upward across toward along
zooming	in out and around down up into through to by along past the off over back is of toward across on
zoomorphic	and figures forms motifs designs figurines form or
zooms	in out to and into the back up are
zoon	politikon
zoonoses	and in
zoonotic	diseases disease infections infection potential
zoophytes	and of are
zooplanktivorous	fish
zooplankton	and in biomass community species of are is communities grazing populations abundance was to population were production from samples as that at on may can by organisms or density have groups feeding which with distribution prey densities standing
zoos	and in are have or to of were is that for as around can with
zoospore	of formation is
zoospores	of are and in or which from that were with is
zoot	suit suits suiters suiter
zooxanthellae	in and are
zorro	de
zoster	virus and is in ophthalmicus infection immune infections oticus of may or are with can viruses has immunoglobulin lesions patients occurs
zoth	century of Century
zou	kunnen zijn de
zowel	de in
zp	is
zr	is
zs	is
zt	is and are
zu	den einer einem sein Berlin der dem machen werden haben sehen finden tun lassen verstehen erkennen geben sagen bringen diesem seinem seiner ihrer Beginn dieser erhalten bestimmen erwarten betrachten nehmen halten beobachten erreichen stellen schaffen suchen sprechen zeigen denken unterscheiden nennen untersuchen konnen Ende gewinnen Leipzig Hause setzen wollen lesen kommen spielen ziehen ihrem vermeiden schreiben Gottingen leben entwickeln gehen erfassen mir denen anderen Wien ihm Koln seinen wissen bezeichnen Grunde beachten rechnen bilden bemerken beschreiben sich dir tragen wenig verwenden leisten entscheiden viel vergleichen sehr reden thun Ehren fassen lernen Gott bleiben ihren verhindern treffen behandeln gelangen diesen bekommen arbeiten erklaren deren ermitteln und beweisen sichern seyn fragen uns Dresden gestalten verbinden trennen richten ersetzen stehen deuten entnehmen verfolgen beurteilen begreifen ihr erzielen allen einigen verschiedenen beantworten weit Recht Anfang ersehen helfen jener legen retten Solz verbessern analysieren glauben folgen verschaffen meiner verlieren singen vermitteln verzeichnen entdecken handeln erheben interpretieren dessen Rom Frankfurt jeder verdanken dienen neuen berechnen gebrauchen bewegen erlangen erfahren beziehen ihnen bewahren behaupten liegen erzeugen studieren verlassen benutzen messen Zeit identifizieren definieren liefern meinem erinnern welchem bieten Hitler Gunsten kennen Tage einander beseitigen hoch achten verwirklichen fordern essen besitzen betonen senden erforschen Hohenlohe sammeln erweitern Halle klein befreien erwartenden bauen bedenken danken nutzen Hamburg wirken zahlen eigen erwerben Eulenburg empfehlen erleichtern sorgen bestehen zwei formulieren Leben jedem kurz vermuten treten urteilen rechtfertigen keiner bewerten verleihen lieben schliessen beeinflussen berichten reduzieren versuchen sterben meinen errichten Kiel gelten entfernen Deutschland Wied Miinchen vertreten Fragen stark vergessen diskutieren begegnen treiben Stolberg realisieren verteidigen vereinigen etwas and gleicher losen unserer kaufen horen hoffen beiden Boden Wort Heidelberg Sachsen wahren beginnen verkaufen Stande entsprechen entwerfen Hannover besuchen charakterisieren behalten rekonstruieren Aristoteles steigern Basel verwandeln Haus Fall Sais Breslau bedienen ergreifen Goethes ordnen welcher verzichten Braunschweig bestimmten Hegels Putlitz werten verlangen schlagen trinken entrichten Unrecht schweigen werfen schicken lenken Munchen befriedigen solchen spat schauen heben jenen entziehen integrieren Luthers keinem untersuchenden unterwerfen wiederholen Hilfe Paris unserem sehn Lasten belegen erweisen verbreiten Bonn Lebzeiten leiden kontrollieren Lande brechen betreiben widmen Neapel empfangen beleuchten organisieren Weimar akzeptieren Kants regeln andern konstruieren bezahlen Augsburg Reventlow vernichten befassen Freiburg versehen beherrschen je leiten Wrede Marburg Wasser bearbeiten in produzieren demselben holen derselben gut schnell viele Hegel erwecken erwartende erscheinen nichts Tode gering bewirken drei erstellen fahren gross Solms fallen Mainz zeichnen miissen mehr unseren lehren schildern Jahr lange Athen Jena allem Holderlins wecken wenden beriicksichtigen is jenem datieren antworten alien korrigieren Dohna binden unternehmen Konigsberg verdeutlichen trauern erteilen verdienen lang Art versetzen vielen Geschichte zweifeln verweisen entgehen rufen Zeiten fiihren Strassburg welchen Karl unterrichten zwingen Goethe erblicken kennzeichnen Tag oft schwach benennen etwa ertragen ehren malen eng heilen weisen warten weiteren decken schenken veranlassen London unterhalten Bremen Worms besprechen teilen reagieren priifen bedeuten entfalten bezweifeln Kant vollziehen verringern folgenden leugnen verhalten erarbeiten Schwarzenberg unterziehen konzentrieren gleichen orientieren umgehen bitten schwer verbergen erleben Dir des enthalten klaren beteiligen pflegen Sprache konstatieren demonstrieren Gebote erlassen erwahnen Problemen Dank Salm isolieren erfolgen Nietzsche erfinden bestellen beschaffen Tubingen Thomas Land einen verwechseln Jerusalem empfinden existieren fuhren Wittenberg erbringen Falun besorgen informieren Wiirzburg bestimmenden verarbeiten Jesus immer Pferde weinen vereinbaren vermehren vertiefen vernehmen Fuss widerlegen vermerken einzelnen gestatten niedrig leicht gewissen hohen Heidegger wahlen erlernen predigen Erfurt Prag vereinen melden verschwinden Nr
zucchini	and in or is with squash into slices bread to are mixture flowers for on yellow blossoms
zudem	die
zueinander	stehen
zuerst	die in von mit das
zufolge	der
zugelassen	werden
zugeordnet	werden
zugeschrieben	werden wird
zugleich	die ein auch eine als mit das der aber den in auf
zugrunde	liegt liegen gelegt liegenden liegende
zugunsten	der des einer
zuletzt	die auch in
zum	Beispiel Neuen Teil Ausdruck Alten Ende ersten Problem Thema anderen Jahre Studium Tode Beginn Schutz einen Leben Vorschein Ausgang Verstandnis erstenmal Gegenstand deutschen Ziel zweiten Schutze Nachweis Zwecke Vergleich Gebrauch neuen Zeitpunkt letzten Verhaltnis Werk Einsatz Zweck Begriff Aufbau Opfer Frieden Theater Himmel Theil siebzigsten Schluss Jahr andern Menschen Ersten Deutschen Gedachtnis Anfang antiken Wesen Sozialismus grossen Weltkrieg Grunde Buschenfelde heutigen Tod Ausbruch dritten Judentum Kriegsausbruch Alien Gesetz mindesten Christentum Text Abschluss Kampf Bau Tragen Besten Wandel Mittelalter sechzigsten Druck Buch Ausgangspunkt alten Gedenken Krieg Inhalt Stillstand Stand Untergang Ganzen Nutzen Guten Verhalten Gebrauche Trotz Ursprung Recht Erfolg politischen Film internationalen Entwurf Zweiten Tanz Meer Unterschied historischen Archiv Essen Bericht Ziele Glauben Unbewussten Weltkriege Staat modernen Fall NT Objekt Verstdndnis griechischen Bild Verkauf gleichen besten System
zumal	die
zumindest	in die im teilweise
zunachst	die in
zuppa	di inglese
zur	Geschichte Kenntnis Zeit deutschen Gegenwart Frage Kenntniss Bestimmung Theorie Lehre Entwicklung Forderung Philosophie Erforschung Theologie Folge Sprache Literatur Untersuchung See Macht Analyse Kunst Herstellung Entstehung Mitte politischen vergleichenden Bildung Physiologie Zeitschrift Biologie Berechnung Religion Hausen Anwendung historischen Anatomie Gesch Soziologie Entwicklungsgeschichte Metaphysik allgemeinen Darstellung Kritik Morphologie Messung Geltung Psychologie Verbesserung Deutschen Diskussion Vorgeschichte Beurteilung Kunstgeschichte Kulturgeschichte Religionssoziologie Wissenschaft Musikwissenschaft Behandlung neueren Ermittlung Welt englischen Philosophic Seite Statistik Politik Feier Beschreibung griechischen Pathologie Wissenschaftslehre Kirchengeschichte Verfugung Erlangung Struktur Verfiigung Losung Bekampfung Linguistik Erfassung Kunde Geistesgeschichte Sprachwissenschaft Germanistik ersten Natur Sprach Arbeit antiken Aufnahme Grundlegung Reformation Erklarung Naturgeschichte Sozialgeschichte Musik Musikgeschichte alten modernen Feststellung Kultur Geologie Erhaltung Beforderung Lage Reform klassischen Physik Sicherung Entstehungsgeschichte Deutung Allgemeinen Einfuhrung Ausstellung Zeitgeschichte Erkenntnis gleichen Erzeugung Bedeutung experimentellen zweiten Funktion Neuzeit Regelung Sozial Ausbildung sozialen Errichtung Systematik mittelalterlichen quantitativen Verwendung Deutschlandpolitik Einleitung Verbreitung Interpretation neuen Chronologie Vollendung Einheit Abwehr Pathogenese Vermeidung wissenschaftlichen Vor romischen Kirchen Kontrolle Begutachtung Wirkung Gewinnung Erreichung Bezeichnung Erde Wirtschafts Bibel Anthropologie Rolle Klinik Rezeption rechten Vorbereitung christlichen Sexualtheorie Englischen weiteren Reformationsgeschichte biblischen Hand pathologischen Erinnerung Charakterisierung Archaologie Freiheit Problematik angewandten romanischen Geophysik Kulturkunde Geschichtswissenschaft Wahrung Pflege Logik Genese Gestaltung Umwelt Form Topographie Unterscheidung Ruhe Ethnographie Volkskunde Methodik Entscheidung Einfiihrung Aufgabe Wochenzeitung Sache praktischen Kirche lateinischen inneren Annahme Judenfrage Wirtschaftsforschung Klarung Grundlage alteren Charakteristik Diagnose Priifung Schaffung Verteidigung internationalen selben Kentniss Methode Physiologic Wahrheit Religionsgeschichte Bewertung Schule normalen Aufklarung chemischen Wiederherstellung Anderung politisch alttestamentlichen Wahl europaischen Phanomenologie Entwickelungsgeschichte Verwirklichung Schau Neurosenlehre Miihlen germanischen Wirklichkeit Biographie literarischen Bundesrepublik Stadt Steigerung Romantik Architektur Rekonstruktion wirtschaftlichen Ethik brandenburgischen Assyriologie Altertumswissenschaft Situation anderen Zukunft Beseitigung Anglistik byzantinischen Beobachtung amerikanischen Wissenschaftsgeschichte Okologie physiologischen Deckung Ikonographie Revolution philosophischen Chemie evangelischen Griindung Histologie Last Urgeschichte Aetiologie arabischen Komposition Technik letzten Flora Integration semitischen Altertumskunde musikalischen Aufstellung Kulturwissenschaft Ordnung Begriindung neuesten Moderne kenntnis Ethnologie Auslegung Auswertung nationalsozialistischen Sonne systematischen neutestamentlichen gesellschaftlichen Apostelgeschichte bayerischen osterreichischen theologischen Lippe Volkerkunde Optik Europaischen Erlauterung Erkennung Literaturgeschichte Gruppe Trennung Demokratie Organisation Morphologic geschichte Bearbeitung reinen Befreiung Geographie Erweiterung Indologie Idee Realisierung Asthetik Schlacht Muhlen Wirtschaftsgeschichte Entdeckung Ur Verhinderung regionalen Amerikanischen Histologic Weimarer theoretischen Kennzeichnung Oeschichte Stabilisierung Syntax Internationalen Republik Revision Diagnostik klinischen Rechtsgeschichte Optimierung Genesis Umsetzung Neuordnung Composition Aussenpolitik Renaissance Konjunkturforschung paulinischen Raumentwicklung Wirkungsgeschichte Durchfuhrung Formgeschichte Steuerung Simulation Definition besseren eigenen Anatomic Psychoanalyse Debatte Antike Durchsetzung Berichtigung Rettung Strassen Konstitution Polarforschung Konstruktion Poetik Voraussetzung dritten Therapie Erzielung staatlichen Atiologie Uberlieferung Naturphilosophie Arbeitsmarkt Erleichterung
zuriick	und
zusammen	mit und zu in
zusammengestellt	von und
zustande	kommt kommen gekommen
zuvor	in
zvith	the
zwanzig	Jahren Jahre
zwanziger	Jahre Jahren
zwanzigsten	Jahrhunderts Jahrhundert
zwar	in nicht die mit im auch eine auf von als der ein durch so aus das nur den sowohl noch an nach bei zu unter keine
zwei	verschiedene Jahre oder Jahren verschiedenen Arten Gruppen weitere Teile Stunden Drittel Wochen bis Seiten von der neue und Welten in Jahrhunderten Tage Teilen Monate Typen ersten Jahrzehnten Banden Stellen Richtungen anderen
zweifellos	die
zweite	Teil Auflage und Gruppe
zweiten	Weltkrieg Teil Halfte Weltkrieges und Fall Jahrhunderts Auflage Generation Jahrhundert Gruppe Phase
zweiter	Ordnung Teil Stelle
zwischen	den dem der zwei beiden diesen ihnen einem einer Ost die verschiedenen Deutschland denen Gott Tradition uns Mensch Reform Staat Schiller Kirche ihm Revolution Kunst Wissenschaft England diesem dieser
zwitterion	form
zwitterionic	form surfactants
zx	and
zydeco	music
zygapophyseal	joints joint
zygapophyses	are
zygapophysial	joint joints
zygoma	and is to or
zygomatic	arch process bone arches bones breadth and complex nerve fossa fractures processes branch fracture branches buttress muscles region major width muscle suture root or plate
zygomaticofrontal	suture
zygomaticomaxillary	suture complex buttress
zygomaticotemporal	nerve
zygomaticus	major minor
zygomorphic	flowers
zygosity	of and
zygospore	is
zygospores	are of
zygote	is and nucleus to or formation has develops divides that in with will of which intrafallopian into undergoes from formed are may begins becomes stage contains by can then would as
zygotene	and stage
zygotes	are and of in with that were to which or is will from
zygotic	embryos embryo induction genes gene and nucleus
zymogen	granules granule is of and activation form
zymogenic	cells
zymosan	particles and
zymotic	diseases disease
zzril	delenit
