Z Anal	Chem
Z Arriving	and
Z Compendium	on
Z Guide	to
Z I	I
Z J	Surg Med Obstet Psychiatry
Z Lebensm	Unters
Z Med	J
Z O	O
Z Physiol	Chem
Z Pola	Walki
Z T	A
Z Vergl	Physiol
Z Z	Z z
Z Zellforsch	Mikrosk
Z and	the Y Z W A X a N H E C S is R then M V its B T
Z are	the not in given
Z as	a the well
Z at	the a
Z axis	is of and
Z be	the a
Z being	the
Z by	the
Z can	be not
Z component	of
Z components	of
Z coordinate	of
Z coordinates	of
Z corresponding	to
Z could	be
Z denote	the
Z denotes	the
Z did	not
Z do	not
Z does	not
Z equal	to
Z et	al
Z flag	is
Z for	the a each
Z from	the
Z guide	to
Z had	been
Z has	a been the
Z have	been
Z in	the a Figure Fig this terms
Z is	the a not an given to defined in called equal also used for less greater then known set Y
Z logo	Reg
Z may	be
Z must	be
Z o	o Z
Z of	the a
Z on	the
Z protons	and
Z represent	the
Z represents	the
Z score	of is for
Z scores	for are
Z should	be
Z so	that
Z stands	for
Z such	that
Z that	is
Z the	zenith
Z to	the be A undo a
Z value	of is for
Z values	are of for
Z was	a
Z which	is
Z will	be
Z with	the a respect
Z would	be have
Z z	z
ZA and	ZB
ZANLA and	ZIPRA
ZANU and	ZAPU
ZAPU and	ZANU
ZEALAND New	Zealand
ZEBRA BOOKS	are KENSINGTON
ZEN AND	THE
ZERO TO	THREE
ZERO ZERO	ZERO
ZIP code	and is
ZK der	SED
ZONE OF	THE
ZONES OF	THE
ZOOLOGICAL SOCIETY	OF
ZOOLOGY OF	THE
ZORA NEALE	HURSTON
Za is	the
Zab and	the
Zacatecas and	Durango
Zacchaeus was	a
Zach and	I
Zach did	not
Zach had	been
Zach shook	his
Zach was	not
Zachariah Chandler	of
Zacharias and	Elizabeth Elisabeth
Zacharias in	the
Zachary Taylor	and was to in had for
Zachos et	al
Zack and	I his
Zack could	not
Zack did	not
Zack had	been
Zack looked	at
Zack was	not
Zacks Investment	Research
Zadok and	Abiathar
Zadok the	priest Priest
Zafar Ali	Khan
Zaghlul and	his
Zagreb and	Belgrade the Ljubljana
Zagreb in	the
Zagros Mountains	of in and
Zahlenwerte und	Funktionen
Zahn et	al
Zail Singh	was and
Zainal Abidin	bin
Zaire Zambia	Zimbabwe
Zaire and	Zambia the Angola Tanzania Uganda Rwanda
Zaire in	the
Zaire to	the
Zajonc and	Markus
Zak et	al
Zakaria Haji	Ahmad
Zakat and	Ushr
Zaken en	Werkgelegenheid
Zakir Husain	was
Zaklad Narodowy	im
Zakopane School	of
Zald and	McCarthy John Ash
Zalman Shazar	Center
Zalman of	Liadi Lyady Liady
Zaltman et	al
Zambesi and	the its Shire
Zambesi to	the
Zambezi River	and in
Zambezi and	the Limpopo its
Zambezi in	the
Zambezi to	the
Zambia African	National
Zambia Congress	of
Zambia Consolidated	Copper
Zambia Daily	Mail
Zambia Information	Services
Zambia and	Zimbabwe Malawi the Tanzania Zaire Mozambique Rhodesia Botswana Angola South other Kenya
Zambia as	a
Zambia at	the
Zambia during	the
Zambia for	the
Zambia has	been a
Zambia in	the
Zambia is	a the
Zambia on	the
Zambia to	the
Zamboanga del	Sur Norte
Zamindari Abolition	and Act Committee
Zamindars and	the
Zamindars of	the
Zamorin and	the
Zamorin of	Calicut
Zanarini et	al
Zander et	al
Zane Grey	and
Zante and	Cephalonia
Zanzibar Nationalist	Party
Zanzibar and	Pemba the Tanganyika East
Zanzibar as	a
Zanzibar for	the
Zanzibar from	the
Zanzibar in	the
Zanzibar is	a
Zanzibar on	the
Zanzibar to	the
Zanzibar was	the
Zapata Lujan	Ponce
Zapata and	the his Villa
Zapata et	al
Zapata in	the
Zapatista Army	of
Zapatista National	Liberation
Zapatista Rebellion	in
Zapatista de	Liberacion
Zapatista movement	in
Zapatista uprising	in
Zapatistas and	the
Zapotec and	Mixtec
Zapotecs and	Mixtecs
Zappa and	the
Zar und	Zimmermann
Zara and	the
Zarathustra and	the
Zarathustra in	the
Zarathustra is	a the
Zarit et	al
Zaroulis and	Sullivan
Zavala County	Sentinel
Zavod za	Statistiku
Zawi Chemi	Shanidar
Zayas y	Sotomayor
Zayed bin	Sultan
Zazie dans	le
Zbigniew Brzezinski	and
Zbirka sudskih	odluka
Zborowski and	Herzog Elizabeth
Ze is	the
Zea mays	and L
Zeal for	the God his your
Zeal in	the
Zeal of	the Thy
Zealand Air	Force
Zealand Antarctic	Research
Zealand Archaeological	Association
Zealand Army	Corps
Zealand Association	for of
Zealand Banking	Group
Zealand Bill	of
Zealand Book	Company
Zealand Broadcasting	Corporation
Zealand Business	Roundtable
Zealand Closer	Economic
Zealand College	of
Zealand Company	and in was
Zealand Constitution	Act
Zealand Council	for of
Zealand Court	of
Zealand Dairy	Board
Zealand Defence	Force
Zealand Department	of
Zealand Division	was and
Zealand Educational	Institute
Zealand Environment	and
Zealand Expeditionary	Force
Zealand Federation	of
Zealand Film	Commission
Zealand First	published
Zealand Forest	Service
Zealand Foundation	for
Zealand Geographical	Society
Zealand Geological	Survey
Zealand Government	to and has
Zealand High	Commission Commissioner
Zealand Historic	Places
Zealand House	of
Zealand Infantry	Brigade
Zealand Institute	of for
Zealand Journal	of
Zealand Labour	Party
Zealand Land	Company
Zealand Law	Society Journal Reports
Zealand Library	Association
Zealand Loan	and
Zealand Maori	Council
Zealand Medical	Journal
Zealand Meteorological	Service
Zealand Minister	of
Zealand Ministry	of
Zealand Mounted	Rifles
Zealand New	Zealand
Zealand Norway	Poland
Zealand Oceanographic	Institute
Zealand Official	Year Yearbook
Zealand Parliamentary	Debates
Zealand Penguin	Books
Zealand Planning	Council
Zealand Politics	in
Zealand Press	Association
Zealand Prime	Minister
Zealand Qualifications	Authority
Zealand Railways	Corporation
Zealand Random	House
Zealand Rugby	Union
Zealand Shipping	Company
Zealand Society	of for
Zealand South	Africa
Zealand Stock	Exchange
Zealand Te	Papa
Zealand Tourism	Board
Zealand United	States Kingdom
Zealand Veterinary	Journal
Zealand White	rabbits
Zealand after	the
Zealand and	the Australia South Australian Canada in its other New Japan to Tasmania a elsewhere India of is overseas Fiji was Britain Hawaii Sweden that some United Singapore then has England British on their Pacific Norway Chile North from Holland Great many
Zealand are	the not
Zealand as	a well the follows an it in
Zealand at	the a
Zealand became	a
Zealand because	of
Zealand before	the
Zealand by	the a
Zealand can	be not
Zealand case	of
Zealand could	not be
Zealand did	not
Zealand do	not
Zealand does	not
Zealand during	the
Zealand fisheries	waters
Zealand for	the a
Zealand from	the
Zealand had	been a to no not
Zealand has	been a not had no the also an
Zealand have	been a
Zealand in	the Parliament a
Zealand is	a the not an in to one that now also concerned very
Zealand it	is was
Zealand journal	of
Zealand may	be
Zealand must	be
Zealand of	the
Zealand on	the a
Zealand or	the Australia elsewhere in any
Zealand over	the
Zealand shall	be
Zealand should	be
Zealand since	the
Zealand species	of
Zealand than	in
Zealand that	the
Zealand there	is are was
Zealand to	the be take a Australia
Zealand under	the
Zealand was	the a not to in
Zealand we	have
Zealand were	the not to
Zealand when	the
Zealand where	the he
Zealand white	rabbits rabbit
Zealand will	be
Zealand with	the a his
Zealand would	be have not
Zealander who	had
Zealanders and	the Australians
Zealanders in	the
Zealots and	the Sicarii
Zealots in	the
Zealous for	the
Zeaman and	House
Zebah and	Zalmunna
Zebedee and	his
Zebedee in	the
Zebra Historical	Romances
Zebra and	the
Zebras Do	not
Zebulon Baird	Vance
Zebulon Montgomery	Pike
Zebulun and	Naphtali the
Zecca dello	Stato
Zechariah and	Elizabeth Malachi the
Zechariah in	the
Zechariah son	of
Zechariah the	son
Zed Books	Ltd and
Zed and	Two
Zedekiah and	his the
Zedekiah king	of
Zedillo Ponce	de
Zedong Thought	and
Zedong and	the Zhou his
Zedong in	the
Zedong junshi	wenji
Zee and	the
Zee et	al
Zeeb Road	Ann
Zeebrugge and	Ostend
Zeeland and	Holland the
Zeeland in	the
Zeeman background	correction
Zeeman effect	in is of and for
Zeeman splitting	of is
Zeichen der	Zeit
Zeigler et	al
Zeit bis	zum zur
Zeit der	Weimarer Reformation Renaissance
Zeit des	Nationalsozialismus Weltbildes
Zeit im	Bild
Zeit in	der
Zeit ist	die
Zeit nach	dem der
Zeit und	Raum Geschichte der Sein Ewigkeit die
Zeit vor	der dem
Zeit zu	Zeit
Zeitalter Jesu	Christi
Zeitalter der	Reformation Fugger Renaissance Aufklarung
Zeitalter des	Imperialismus Barock
Zeitalter seiner	technischen
Zeiten bis	auf zur
Zeiten und	Volker
Zeitgeist of	the
Zeithaml et	al
Zeitschrif t	fur
Zeitschrift der	Deutschen Savigny deutschen Gesellschaft Humboldt
Zeitschrift des	Vereins Deutschen deutschen Vereines
Zeitschrift fiir	die Ethnologie Musik Soziologie Tierpsychologie Theologie Physik Psychologie vergleichende Kirchengeschichte angewandte deutsche
Zeitschrift fuer	die
Zeitschrift fur	die Soziologie Musik Ethnologie Physik Tierpsychologie Psychologie Geomorphologie Theologie Kirchengeschichte vergleichende deutsche angewandte Philosophie Kunstgeschichte romanische Assyriologie Nationalokonomie deutsches Sozialforschung das Papyrologie Geschichte Angewandte Geschichtswissenschaft wissenschaftliche Volkswirtschaft Volkskunde auslandisches Politik Psychoanalyse Naturforschung Betriebswirtschaft Hygiene Phonetik katholische bildende Ethnologic Musikwissenschaft Geopolitik Zellforschung Philosophic Morphologie physikalische Missionswissenschaft Vergleichende philosophische Biologie physiologische Romanische Anglistik Religions Psychiatrie Psychologic celtische Volkerpsychologie historische Mathematik allgemeine Wissenschaftliche systematische Parasitenkunde Nervenheilkunde Parlamentsfragen betriebswirtschaftliche Physikalische Literaturwissenschaft Kunst Gletscherkunde offentliches Kristallographie
Zeitung and	the
Zeitung des	Judentums Judenthums
Zeitung fur	die
Zeke did	not
Zelda and	Scott I
Zelikow and	Rice
Zell am	See
Zeller et	al
Zellforsch Mikrosk	Anat
Zelnik and	Kantner
Zemlia i	Volia
Zemlya and	the
Zemlya i	Volya
Zemon Davis	and
Zen Buddhism	and in is to was has as
Zen Buddhist	monk
Zen Center	of in
Zen Doctrine	of
Zen Institute	of
Zen Master	Dogen Hakuin
Zen Mountain	Monastery Center
Zen Teaching	of
Zen and	the Japanese other Zen Western
Zen as	a
Zen does	not
Zen in	the Japan China English
Zen is	not a the to
Zen master	who and of Dogen in
Zen masters	of and
Zen meditation	and
Zen monastery	in
Zen of	the
Zen practice	is
Zen sect	of
Zen temple	in
Zen to	the
Zenana Missionary	Society
Zener diode	is
Zener diodes	are
Zeng et	al
Zenith Data	Systems
Zenith Radio	Corporation
Zenith and	Nadir
Zenith of	the
Zeno and	the his Chrysippus Epicurus Cleanthes Anastasius Parmenides
Zeno at	Verona
Zeno in	the Verona
Zeno of	Elea Citium Verona Sidon
Zeno the	Stoic Eleatic
Zeno was	a
Zenobia of	Palmyra
Zentralblatt fur	Bakteriologie Bibliothekswesen Psychoanalyse Mathematik die
Zentralverlag der	NSDAP
Zentrum Paul	Klee
Zentrum fur	Europaische
Zeolite Molecular	Sieves
Zeolite Science	and
Zephyr gently	blows
Zephyrinus and	Callistus
Zeppelin and	the
Zeppelin raid	on
Zeppelin raids	on
Zerah the	Ethiopian
Zeri i	Popullit
Zero Base	Budgeting
Zero Coupon	Bonds
Zero Length	Indexed
Zero Population	Growth
Zero Zero	Zero
Zero and	the
Zero at	the
Zero coupon	bonds
Zero de	Conduite conduite
Zero hour	was
Zero in	on the
Zero is	the a not
Zero of	the
Zero on	the
Zero or	more
Zero population	growth
Zero to	Three
Zeroing in	on
Zeros in	the
Zeroth Law	of
Zerubbabel and	Joshua the Jeshua
Zerubbabel the	son
Zeszyty Naukowe	Uniwersytetu
Zeta Beta	Tau
Zeta Phi	Beta Eta
Zeta Tau	Alpha
Zetes and	Calais
Zethus and	Amphion
Zeus and	the Hera his Apollo Athena Hermes Poseidon Leto Jupiter Semele of Demeter Dione a Leda Mnemosyne Europa all Themis Athene to Prometheus Maia Ganymede other
Zeus as	the a
Zeus at	Olympia Dodona the Athens
Zeus by	the
Zeus came	to
Zeus did	not
Zeus does	not
Zeus for	the
Zeus from	the
Zeus had	been
Zeus in	the his a Olympia
Zeus is	the a not
Zeus of	the Phidias Olympia Dodona
Zeus on	the Mount
Zeus or	Jupiter the Apollo
Zeus that	he
Zeus the	Saviour
Zeus to	the be
Zeus was	the a not born
Zeus with	the a his
Zeuxis and	Parrhasius
Zhai et	al
Zhan et	al
Zhang Chunqiao	and
Zhang Department	of
Zhang and	his
Zhang et	al
Zhao Ziyang	and was in
Zhao et	al
Zhdanov and	the
Zhejiang and	Jiangsu Fujian
Zhejiang renmin	chubanshe
Zheng et	al
Zhi Gan	Cao
Zhong et	al
Zhonggong dangshi	ziliao
Zhonggong zhongyang	dangxiao
Zhongguo Shehui	Kexue
Zhongguo Tongji	Nianjian Chubanshe
Zhongguo qingnian	bao
Zhongguo renmin	daxue
Zhongguo shehui	kexue
Zhongguo tongji	chubanshe nianjian
Zhonghua Renmin	Gongheguo
Zhonghua renmin	gongheguo
Zhongyang wenxian	chubanshe
Zhou Enlai	and in was had to on nianpu as
Zhou and	the Bankston
Zhou et	al
Zhu De	and
Zhu Rongji	and
Zhu Xi	and
Zhu et	al
Zhuang Autonomous	Region
Zhuang et	al
Zhurnal Moskovskoi	Patriarkhii
Zi is	the
Zia and	the his
Zia ul	Haq
Ziedses des	Plantes
Ziegfeld Follies	of and
Ziegler and	Nichols
Ziegler et	al
Ziele und	Wege
Zielinski et	al
Zienkiewicz et	al
Zigler and	Phillips
Zigler et	al
Zila Parishad	and is
Zila Parishads	Act and
Zilboorg and	Henry
Zilla Parishad	and or is in
Zilla Parishads	and Act
Zillmann and	Bryant
Zilpha Keatley	Snyder
Zim Israel	Navigation
Zimbabwe African	National People Peoples
Zimbabwe Broadcasting	Corporation
Zimbabwe Congress	of
Zimbabwe Institute	of
Zimbabwe International	Book
Zimbabwe National	Army Archives
Zimbabwe Publishing	House
Zimbabwe and	the South Namibia Zambia Mozambique Botswana Malawi other Kenya in
Zimbabwe as	a
Zimbabwe at	the
Zimbabwe during	the
Zimbabwe has	been a
Zimbabwe have	been
Zimbabwe in	the
Zimbabwe is	a the
Zimbabwe on	the
Zimbabwe to	the
Zimbabwe was	the
Zimbalist Rosaldo	and
Zimbardo et	al
Zimmer et	al
Zimmerli Art	Museum
Zimmerman Temperament	Survey
Zimmerman and	West
Zimmerman et	al
Zimmerman of	the
Zimmermann et	al
Zimmerwald and	Kienthal
Zimring and	Hawkins Gordon
Zinc Development	Association
Zinc Research	Organization
Zinc Study	Group
Zinc Zinc	is
Zinc and	copper lead Lead Copper cadmium Cadmium
Zinc can	be
Zinc chloride	is
Zinc deficiency	in is and has
Zinc has	been a
Zinc in	the
Zinc is	a also an used the found not
Zinc may	be
Zinc oxide	is and
Zinc phosphate	cement
Zingiber officinale	Roscoe
Zinkernagel and	Doherty
Zinn et	al
Zinoviev and	Kamenev Trotsky Bukharin
Zinzendorf and	the his
Zion Baptist	Church
Zion Christian	Church
Zion Church	in and of was
Zion Evangelical	Lutheran
Zion Hospital	and
Zion Lutheran	Church
Zion Methodist	Church
Zion Mule	Corps
Zion National	Park
Zion Publishing	House
Zion a	stone
Zion and	the Jerusalem in to Bryce its
Zion are	haughty
Zion as	the a
Zion at	the
Zion by	the
Zion for	a the
Zion from	the
Zion had	been
Zion has	been
Zion in	the Jerusalem America a
Zion is	the a to not
Zion more	than
Zion of	the God
Zion on	the
Zion shall	go be
Zion to	the be
Zion was	the a not
Zion will	be
Zion with	songs the a singing
Zion would	be
Zionism and	the Israel its Jewish Judaism imperialism to anti of Palestine a
Zionism as	a an the
Zionism at	the
Zionism did	not
Zionism from	the
Zionism had	been
Zionism has	been
Zionism in	the Palestine America its
Zionism is	a the not to racism an
Zionism of	the
Zionism on	the
Zionism to	the Our be
Zionism was	a the not to an
Zionism with	racism the
Zionist Actions	Committee
Zionist Archives	and
Zionist Commission	in
Zionist Congress	in at was of and held
Zionist Emergency	Council
Zionist Executive	in and
Zionist Federation	of and
Zionist General	Council
Zionist Movement	and in
Zionist Occupation	Government
Zionist Organisation	and
Zionist Organization	of and in was to as
Zionist activities	in
Zionist activity	in
Zionist and	anti non Jewish a Israeli the
Zionist cause	and
Zionist dream	of
Zionist groups	in
Zionist ideology	and
Zionist in	the
Zionist leader	and
Zionist leaders	in were and to had who
Zionist leadership	in
Zionist movement	and in was to had as is has that of which for
Zionist organization	in and
Zionist organizations	in and
Zionist point	of
Zionist policy	of
Zionist settlement	in
Zionist state	in
Zionist youth	movement movements groups group organization
Zionists and	the non their anti
Zionists did	not
Zionists had	been
Zionists in	the Palestine
Zionists of	the America
Zionists on	the
Zionists were	not
Zionists who	were had
Zip Code	Allow For Dear Phone Telephone
Zip Daytime	Phone
Zip I	have
Zip Please	allow send
Zip Send	order
Zippo Dot	Com
Zirconium and	Hafnium
Zirconium in	the
Zito et	al
Zj is	the
Zlateh the	Goat
Zn Ga	Ge
Zn and	Cu Cd Pb Mn Fe Ni the Mg S
Zn can	be
Zn concentration	in
Zn concentrations	in
Zn content	of
Zn deficiency	in
Zn from	the
Zn in	the
Zn is	the
Zn superoxide	dismutase
ZnO thin	films
Zo is	the
Zobel de	Ayala
Zobel et	al
Zodiac and	the
Zodiac in	the
Zodiacal Light	and
Zoe and	I Theodora her
Zoe could	not
Zoe did	not
Zoe had	been
Zoe looked	at
Zoe shook	her
Zoe was	not
Zohar and	the
Zohar et	al
Zohary and	Hopf
Zola and	the his Maupassant
Zola as	a
Zola did	not
Zola had	been
Zola in	his the
Zola is	a
Zola was	a
Zollverein and	the
Zona da	Mata
Zonal distribution	of
Zonation of	the
Zondervan Bible	Publishers
Zondervan Pictorial	Encyclopedia
Zondervan Publishing	House
ZondervanPublishingHouse Grand	Rapids
Zone A	and is
Zone Act	of
Zone Color	Scanner
Zone Conservation	Commission
Zone I	and is Zone
Zone II	is and Zone
Zone III	is
Zone In	the
Zone Information	Protocol
Zone Management	Act Program Journal Plan in
Zone Research	Institute
Zone This	zone
Zone Tower	of
Zone Zone	Zone
Zone and	the in to its a
Zone as	a well
Zone at	the
Zone between	the
Zone by	the
Zone can	be
Zone during	the
Zone electrophoresis	in
Zone for	the
Zone from	the
Zone had	been
Zone has	been
Zone have	been
Zone in	the Germany which
Zone is	a the not
Zone may	be
Zone of	the Peace Germany Occupation Proximal proximal Interior Morocco a Cooperation occupation Southwest Emergence saturation
Zone on	the
Zone or	the
Zone shall	be
Zone should	be
Zone to	the be
Zone under	the
Zone was	a not the
Zone where	the
Zone will	be
Zone with	the
Zone would	be
Zones A	and
Zones Act	of
Zones I	and
Zones II	and
Zones and	the
Zones in	the
Zones of	the Occupation Germany Upper Peace India
Zoning Appeals	of
Zoning Board	of
Zoning Commission	of
Zoning Enabling	Act
Zoning Hearing	Bd Board
Zoning Law	and
Zoning Ordinance	of
Zoning and	Planning Land the
Zoning in	the
Zoning is	a the
Zoning of	the
Zonotrichia leucophrys	gambelii
Zoo Wildl	Med
Zoo and	the Aquarium Wild Botanical Wildlife
Zoo in	the Washington New
Zoo is	a
Zoogeography of	the
Zool Soc	Lond
Zoologica di	Napoli
Zoological Department	of
Zoological Garden	in
Zoological Gardens	in of and at
Zoological Institute	of
Zoological Journal	of
Zoological Laboratory	of
Zoological Museum	of in at
Zoological Park	in and
Zoological Parks	and
Zoological Society	of and in for
Zoological Station	at
Zoological Survey	of
Zoological and	Botanical
Zoologique de	France
Zoologisches Institut	der
Zoology Department	of
Zoology University	of
Zoology and	Botany Comparative Entomology Physiology Geology the
Zoology at	the Harvard Cambridge
Zoology in	the
Zoology of	the
Zoom Extents	All
Zoom In	button and tool Zoom
Zoom Out	button
Zoom and	Pan
Zoom dialog	box
Zoom in	on to and
Zoom into	the
Zoom tool	to
Zooming in	on
Zooplankton in	the
Zoos and	Aquariums
Zoot Suit	Riots
Zophar the	Naamathite
Zora Neal	Hurston
Zora Neale	Hurston
Zorah and	Eshtaol
Zorba the	Greek
Zoroaster and	the his
Zoroaster in	the
Zoroaster was	a the
Zoroastrianism and	the
Zorrilla de	San
Zou et	al
Zouaves and	the
Zr and	Hf Ti Nb
Zr in	the
Zsa Zsa	Gabor
Zt is	the
Zu Beginn	der
Zu San	Li
Zu diesem	Zweck Zwecke
Zu dieser	Zeit
Zuber et	al
Zubok and	Pleshakov
Zucker et	al
Zuckerkandl and	Pauling
Zuckerman et	al
Zugang zu	den
Zugleich ein	Beitrag
Zuider Zee	and
Zuiver Wetenschappelijk	Onderzoek
Zulfikar Ali	Bhutto
Zulfiqar Ali	Bhutto Khan
Zulu War	of and
Zulu and	the Xhosa Swazi
Zulu army	was
Zulu in	the
Zulu of	South Natal
Zulu royal	house
Zululand and	Natal the
Zululand in	the
Zulus and	the
Zulus had	been
Zulus in	the South
Zulus on	the
Zum Begriff	der des
Zum Problem	der des
Zum Stand	der
Zum Verhaltnis	von
Zum Verstandnis	der
Zum ewigen	Frieden
Zung Depression	Scale
Zuni Folk	Tales
Zuni Indians	of
Zuni Salt	Lake
Zuni and	Hopi the
Zur Aetiologie	der
Zur Analyse	der
Zur Anatomie	und der des
Zur Bedeutung	der des von
Zur Behandlung	der
Zur Berechnung	der
Zur Bestimmung	der des
Zur Beurteilung	der
Zur Biologie	der und
Zur Chronologie	der
Zur Datierung	der
Zur Deutung	der
Zur Elektrodynamik	bewegter
Zur Entstehung	der des und
Zur Entstehungsgeschichte	des der
Zur Entwicklung	der des
Zur Entwicklungsgeschichte	der des
Zur Erinnerung	an
Zur Frage	der des nach iiber
Zur Funktion	der
Zur Genealogie	der
Zur Genese	der
Zur Genesis	der
Zur Geschichte	der des und von eines
Zur Grundlegung	der
Zur Kenntnis	der des
Zur Kenntniss	der des
Zur Klinik	und
Zur Kritik	der des
Zur Lage	der
Zur Lehre	von vom
Zur Logik	der
Zur Methodik	der
Zur Morphologie	der und des
Zur Pathogenese	der
Zur Pathologie	der
Zur Physiologie	der des
Zur Problematik	der des
Zur Psychologie	des der
Zur Psychopathologie	des
Zur Quantentheorie	der
Zur Rekonstruktion	des
Zur Rolle	der des
Zur Sache	des
Zur Situation	der
Zur Soziologie	des der
Zur Stellung	der
Zur Struktur	des der
Zur Systematik	der
Zur Technik	der
Zur Theologie	der des
Zur Theorie	der des und
Zur Vorgeschichte	des der
Zur Zeit	der
Zur pathologischen	Anatomie
Zur vergleichenden	Anatomie
Zurich Financial	Services
Zurich Research	Laboratory
Zurich Stock	Exchange
Zurich and	the Geneva London Berne Bern Stuttgart Munich Basel New in Paris Leipzig then
Zurich as	a
Zurich at	the
Zurich by	the
Zurich during	the
Zurich for	the a
Zurich in	the Switzerland
Zurich is	the
Zurich on	the
Zurich to	the
Zurich was	the
Zurich where	he
Zurich with	the
Zurilla and	Goldfried
Zusammenarbeit mit	dem der den
Zusammenhang mit	der dem den einer
Zusammenhang zwischen	der den dem
Zustimmung des	Verlages
Zuyder Zee	and
Zvezda and	Leningrad
Zwaan et	al
Zweck im	Recht
Zwei Falle	von
Zweifel an	der
Zweigert and	Kotz
Zweites Deutsches	Fernsehen
Zwingli and	Calvin the his Luther Bullinger Oecolampadius
Zwingli did	not
Zwingli in	Zurich the
Zwischen Himmel	und
Zwischen den	Zeiten
Zygmunt Bauman	has
Zygomatic process	of
Zygote intrafallopian	transfer
Zyklon B	gas
z A	B
z CO	CO
z I	I z
z In	the
z Z	Z z
z a	t
z above	the
z according	to
z along	the
z and	the z y x t a w is r s then time v p u that
z are	the not given
z as	a the in well
z at	the time a
z axes	are of respectively
z axis	is and of in with at as to along
z be	the a
z being	the
z below	the
z between	the
z by	the a
z can	be not
z component	of
z components	of
z coordinate	of system is
z coordinates	of
z corresponding	to
z corresponds	to
z denote	the
z denotes	the
z dependence	of
z direction	is and with in of
z directions	are respectively
z does	not
z due	to
z equal	to
z for	the a which each
z from	the
z has	a been the
z in	the a terms this azure
z instead	of
z into	the
z is	the a given not an in equal defined measured greater positive less to used then negative also called determined taken zero obtained found
z may	be
z must	be
z o	o z u I CO
z of	the a
z on	the
z per	cent
z plane	and is
z punktu	widzenia
z represent	the
z represents	the
z score	of is for and
z scores	for are and of
z should	be
z so	that
z such	that
z test	for
z that	is
z to	the be a
z transform	of
z value	of is for corresponding
z values	of are for
z we	have
z which	is
z will	be
z with	respect the a
z would	be
z z	z o Z I
za is	the
za t	i
zags of	the
zaibatsu and	the
zamindar and	the
zamindar of	the
zamindars and	the other their
zamindars in	the
zamindars of	the
zat i	on
zat ion	of
zation of	the
zavod za	statistiku
zeal I	have served
zeal about	the
zeal according	to
zeal against	the popery Popery
zeal among	the
zeal and	energy activity devotion ability enthusiasm the fidelity courage success industry diligence perseverance earnestness love affection piety a his intelligence attachment efficiency good ardour determination loyalty assiduity spirit self fervour interest alacrity charity liberality attention sincerity with their fervor skill eloquence care ardor patriotism vigour abilities an faith prudence confidence faithfulness to passion enterprise exertions patience of dedication power talent learning talents knowledge integrity vigor devotedness in unanimity resolution discretion ambition wisdom bravery firmness eagerness constancy intrepidity desire gallantry effort ingenuity capacity great public efforts commitment judgment untiring anxiety vigilance indignation by application zest all warmth labour boldness fortitude kindness promptitude generosity valour concern strength that honesty my purity exertion indefatigable disinterestedness
zeal as	a the if to he well an they
zeal at	the
zeal began	to
zeal by	the which a
zeal can	not be
zeal could	not
zeal did	not
zeal displayed	by in
zeal does	not
zeal during	the
zeal equal	to
zeal for	the his God religion their a reform truth liberty learning your its souls education justice her what our social knowledge public my this righteousness it Christ orthodoxy good His Christianity freedom work religious science that making an promoting different improvement study virtue all any reformation peace which him self human life service those political these missions purity conversion some Christian them me one
zeal from	the
zeal had	been not
zeal has	been
zeal he	had has was displayed
zeal in	the his this their behalf a promoting its defence carrying our favour all support her that defending religion my favor your making preaching collecting every supporting pursuing
zeal into	the
zeal is	not a the
zeal led	him
zeal made	him
zeal manifested	by
zeal may	be have
zeal might	be
zeal must	be
zeal of	the a his their those an its some our these this God her many my that one all your thine such others men certain both party which youth new Christians thy religious missionaries religion
zeal on	the behalf this his
zeal or	the
zeal rather	than
zeal seems	to
zeal should	be
zeal shown	by
zeal so	far
zeal than	discretion the knowledge ever judgment prudence
zeal that	he the was had is they I would has it
zeal they	had have
zeal to	the make serve be promote do his get protect bring save defend spread convert destroy carry help maintain preserve establish reform have support keep see win their God prove find improve a secure give advance show propagate prevent learn put work obtain
zeal towards	the
zeal upon	the
zeal was	not the so a rewarded
zeal which	he is had the they was has I you animated would
zeal will	be
zeal with	which the a
zeal without	knowledge
zeal worthy	of
zeal would	be have
zeal you	have
zealot for	the
zealot in	the
zealot of	the
zealotry of	the
zealots and	the
zealots for	the
zealots in	the
zealots of	the
zealots who	had were
zealous Roman	Catholic
zealous about	the
zealous adherence	to
zealous adherent	of
zealous adherents	of
zealous admirer	of
zealous advocacy	of
zealous advocate	of for
zealous advocates	of for
zealous against	the
zealous and	active faithful able devoted efficient successful indefatigable intelligent energetic earnest pious learned sincere useful effective persevering enthusiastic untiring well affectionate most conscientious diligent devout disinterested the self powerful
zealous application	of
zealous as	the he a
zealous assertor	of
zealous attachment	to
zealous attempt	to
zealous attempts	to
zealous attention	to
zealous champion	of
zealous champions	of
zealous commitment	to
zealous concern	for
zealous convert	to
zealous defender	of
zealous defenders	of
zealous desire	to
zealous devotion	to
zealous discharge	of
zealous disciple	of
zealous disciples	of
zealous effort	to
zealous efforts	of to in
zealous endeavours	to
zealous enough	to
zealous exertions	of
zealous follower	of
zealous followers	of
zealous for	the his their God a its good it her religion
zealous friend	of to
zealous friends	of
zealous guardian	of
zealous guardians	of
zealous in	the his their promoting its this her our maintaining protecting defending a all
zealous interest	in
zealous lover	of
zealous member	of
zealous members	of
zealous of	good the his their all
zealous on	the
zealous opponent	of
zealous opponents	of
zealous opposition	to
zealous part	in
zealous partisan	of
zealous partisans	of
zealous patron	of
zealous patrons	of
zealous performance	of
zealous preacher	of
zealous promoter	of
zealous promoters	of
zealous prosecution	of
zealous pursuit	of
zealous regard	for
zealous servant	of
zealous servants	of
zealous student	of
zealous study	of
zealous support	of
zealous supporter	of
zealous supporters	of
zealous than	the
zealous to	promote do maintain serve be preserve defend
zealous upholder	of
zealous use	of
zealous worker	in
zealously and	successfully faithfully
zealously as	the
zealously attached	to
zealously defended	the by
zealously devoted	to
zealously endeavoured	to
zealously engaged	in
zealously for	the
zealously guarded	by the
zealously in	the
zealously into	the
zealously promoted	the
zealously sought	to
zealously supported	by the
zealously than	ever
zealously to	the work
zealously with	the
zealously within	the
zealousness of	the
zebra and	the wildebeest a
zebra finch	song
zebra in	the
zeichnen sich	durch
zeichnet sich	durch
zeigt sich	in auch die
zeir of	God
zeitgeist of	the
zemindars of	the
zemstvos and	the
zener diode	is
zenith and	the nadir was
zenith angle	of and is
zenith angles	of
zenith as	a
zenith at	the noon
zenith by	the
zenith distance	of is and
zenith distances	of
zenith during	the
zenith from	the
zenith in	the a
zenith is	the
zenith of	his its the their her power a this my prosperity our human popularity glory
zenith on	the
zenith to	the horizon
zenith under	the
zenith when	the
zenith with	the
zens of	the
zeolite in	the
zeolites can	be
zeolites have	been
zeolites in	the
zephyrs of	the
zero according	to
zero after	the a each
zero again	at
zero all	the
zero along	the
zero amount	of
zero and	the one a that variance then is unity infinity solving we there hence therefore thus so no it its standard all negative first less to in solve at an this are two for can not unit maximum positive if only increases covariance with constant infinite will span has some non when full three as their of five may any nonzero also increasing even they have finite where four ten becomes consequently
zero angle	of
zero angular	momentum
zero applied	field voltage
zero are	called not the
zero as	the a n possible well in it t shown we T x long time an r its soon is one N
zero at	the a all this some infinity any zero each about an that t both every x time one s low r high large point absolute its these equilibrium T and night infinite A least which very points z
zero average	value
zero balance	in
zero base	budgeting line
zero basis	in
zero because	the of it there they no
zero before	the
zero being	the
zero below	the
zero bending	moment
zero between	the
zero bias	and
zero boundary	conditions
zero bracket	amount
zero but	the less is
zero by	the a definition means an
zero can	be not
zero chance	of
zero change	in
zero charge	and of
zero coefficient	of
zero coefficients	in
zero component	of
zero components	of
zero concentration	of
zero contact	angle
zero contribution	to
zero correlation	between with
zero corresponding	to
zero corresponds	to
zero cosmological	constant
zero cost	to of
zero could	be
zero coupon	bonds bond
zero crossing	of point
zero crossings	of in
zero current	in and
zero decimal	places
zero defects	and
zero degree	of
zero degrees	of Fahrenheit and centigrade Celsius
zero depending	on
zero dipole	moment
zero discharge	of
zero discount	rate
zero dispersion	wavelength
zero divided	by
zero does	not
zero due	to
zero during	the
zero each	time
zero economic	profit profits growth
zero effect	on
zero eigenvalues	of
zero elasticity	of
zero electric	field charge
zero element	of in
zero elements	in of are
zero end	of
zero entries	in
zero even	though if when
zero everywhere	except else in
zero except	for the at in when
zero excess	demand
zero exit	status
zero expected	value
zero external	field
zero faster	than
zero field	splitting and is
zero flag	is
zero for	the all a any each an both this t large some every that negative those most one r x these zero two and n no very
zero frequency	and is to
zero from	the which a
zero gate	voltage bias
zero gives	the
zero gravity	and
zero growth	rate in
zero has	been a
zero have	been
zero hour	of for was
zero hours	of
zero if	the it there and no a they we all not you
zero implies	that
zero in	the on a this all order each both any an some one Eq that every equation such these our prices winter its most equilibrium their front either case
zero indicates	that the a no
zero inflation	rate
zero initial	conditions velocity condition
zero insertion	force
zero inside	the
zero instead	of
zero interest	rate in rates
zero into	the
zero ionic	strength
zero is	the not a called used returned an zero to at given that reached undefined placed equal also in assigned obtained equivalent added represented known always
zero it	is
zero kinetic	energy
zero leads	to
zero level	of set is in and for
zero levels	of
zero line	of is and on in at
zero lower	bound
zero magnetic	field moment
zero marginal	cost productivity product
zero mark	on of and is
zero mass	and
zero matrix	elements
zero may	be
zero mean	and value Gaussian stress white random
zero means	that and
zero momentum	transfer
zero more	rapidly
zero must	be
zero near	the
zero net	charge present force investment
zero no	matter
zero nuclear	spin
zero of	the temperature energy a potential Fahrenheit time this
zero on	the a this all both failure
zero only	if when for in at
zero opportunity	cost
zero or	more one negative less a positive very even the near low to infinity negligible not unity greater close an below infinite small at some nearly any is slightly two nonzero blank if non
zero orbital	angular
zero order	in correlation correlations and kinetics with reaction approximation of hold
zero out	the of
zero output	voltage impedance
zero outside	the of this
zero over	the a
zero path	difference
zero per	cent
zero percent	of
zero phase	shift angle difference
zero phonon	line
zero plane	displacement
zero plot	of
zero point	of energy is on and for in at to energies from or was motion as
zero points	of for
zero population	growth
zero position	of is and by
zero potential	energy and difference
zero power	factor is
zero pressure	gradient and is at
zero prior	to
zero probability	of that to
zero profit	condition
zero rate	of
zero rates	of
zero rather	than
zero reading	of on is
zero real	part
zero reference	point level
zero refers	to
zero regardless	of
zero relative	velocity to
zero represents	the
zero residual	value
zero resistance	and
zero rest	mass
zero results	in
zero salvage	value
zero scattering	angle
zero sequence	current currents
zero set	of
zero shear	rate viscosity stress
zero should	be
zero since	the it there
zero slope	at
zero so	that the
zero speed	and
zero stress	at
zero such	that
zero sum	game games
zero tax	rate
zero temperature	coefficient and is the
zero temperatures	and
zero than	the
zero that	the is
zero the	first coefficients
zero then	the
zero there	is
zero through	nine the
zero throughout	the
zero time	and to is delay of the
zero to	the a one infinity ten three maximum four about five its some unity two nine six full be sixty over more an indicate several eight obtain many twenty seven any positive as find approximately all zero almost negative nearly that
zero tolerance	for policy policies of policing
zero transaction	costs
zero transactions	costs
zero under	the
zero units	of
zero unless	the
zero until	the
zero up	to
zero using	the
zero value	of for at is in to and on when if
zero values	of for in at are and
zero velocity	at and in
zero voltage	across
zero volts	and
zero we	have obtain can get
zero weather	and
zero weight	to
zero when	the it a there x no they we all t and n
zero whenever	the
zero where	the
zero which	is
zero while	the
zero will	be
zero with	the a increasing respect no an
zero within	the a
zero would	be
zero yields	the
zero zero	zero
zeroed in	on
zeroes and	ones
zeroes in	on the
zeroes of	the
zeroes to	the
zeroing in	on
zeroing of	the
zeros after	the it
zeros and	ones poles the a
zeros are	not added the
zeros at	the
zeros between	the
zeros can	be
zeros except	for
zeros for	the
zeros from	the
zeros have	been
zeros in	the on a all
zeros may	be
zeros must	be
zeros of	the a G F this f A
zeros on	the
zeros or	ones
zeros that	are
zeros to	the be
zeros will	be
zeroth and	first
zeroth law	of
zeroth order	in approximation
zest and	juice enthusiasm interest a energy the enjoyment joy zeal relish spirit pleasure vitality vigor
zest for	life living the work learning adventure a it his action knowledge
zest from	the
zest in	the life a his living
zest into	the
zest of	the a life his living an youth
zest out	of
zest to	the his life their our a your my her all this every
zest with	which
zeta potential	of is and measurements
zeta potentials	of
zhes bya	ba
zhizni i	tvorchestva
zhongyang dangxiao	chubanshe
zi is	the
zig and	zag
zigged and	zagged
zigging and	zagging
zigs and	zags
zigzag across	the
zigzag back	and
zigzag course	of to
zigzag down	the
zigzag in	the
zigzag line	of
zigzag lines	of and
zigzag of	the
zigzag on	the
zigzag path	to of
zigzag pattern	of
zigzag through	the
zigzag to	the
zigzag up	the
zigzagged across	the
zigzagged back	and
zigzagged down	the
zigzagged through	the
zigzagged up	the
zigzagging across	the
zigzagging back	and
zigzagging down	the
zigzagging through	the
zigzagging up	the
zigzags across	the
zigzags in	the
zigzags of	the
zigzags on	the
zigzags through	the
zigzags to	the
zigzags up	the
zijn in	de
zijn van	de
zijn voor	de
zillah and	city
zinc absorption	in and
zinc acetate	solution
zinc alloys	are
zinc and	copper lead cadmium iron the other silver manganese tin a magnesium nickel carbon aluminum zinc hydrochloric sulphuric aluminium mercury platinum calcium selenium vitamin dilute its acid sulphur of cobalt one chromium antimony is sulfur molybdenum potassium arsenic water
zinc are	also the used found not
zinc as	a the well an
zinc at	the a
zinc blende	structure and
zinc by	the a
zinc can	be not
zinc chloride	and solution is in or to as are
zinc chromate	primer
zinc coating	is
zinc concentration	in of
zinc concentrations	in
zinc contained	in
zinc content	of in is
zinc contents	of
zinc could	be
zinc deficiency	in and is on may has can
zinc deposits	of in
zinc die	castings
zinc dissolved	in
zinc dissolves	in
zinc does	not
zinc dust	and in is to
zinc electrode	is in
zinc end	of
zinc finger	protein proteins motif transcription domain motifs domains
zinc for	the
zinc from	the a its
zinc gluconate	lozenges
zinc goes	into
zinc had	been
zinc has	been a
zinc have	been
zinc immersed	in
zinc in	the a an dilute this solution copper their hydrochloric human contact
zinc instead	of
zinc insulin	is
zinc into	the a
zinc ion	is
zinc ions	in are and
zinc is	used not the a dissolved added placed present in also to immersed an deposited precipitated found very more then obtained removed formed
zinc levels	in are were and
zinc may	be
zinc metabolism	in
zinc metal	is
zinc mine	in
zinc mines	in of
zinc must	be
zinc of	the one
zinc on	the a
zinc or	copper iron cadmium tin lead aluminum magnesium other aluminium zinc of
zinc ore	in and is
zinc ores	of in are and
zinc oxide	and is in or ointment with to are powder paste as eugenol on was by
zinc per	day
zinc phosphate	cement cements and
zinc plate	is and of in
zinc plates	are in
zinc pole	of
zinc present	in
zinc salt	of
zinc salts	are
zinc should	be
zinc status	of
zinc sulfate	solution and in is
zinc sulfide	and is screen
zinc sulphate	solution and is in or to
zinc sulphide	screen is and
zinc superoxide	dismutase
zinc supplementation	on in
zinc through	the
zinc to	the be copper form a prevent
zinc uranyl	acetate
zinc used	in
zinc which	is
zinc white	and
zinc will	be
zinc with	a the
zinc would	be
zip around	the
zip code	and is of in areas area or for to order on
zip codes	in and are
zip in	the
zip it	up
zip of	the her
zip or	postal
zip through	the
zip to	the
zip up	the and his my
zipped across	the
zipped around	the
zipped down	the
zipped his	pants
zipped into	the a
zipped it	up shut
zipped the	bag
zipped through	the
zipped up	his the her and my to in
zipper at	the
zipper in	the
zipper of	her his the
zipper on	the his her my
zipper to	the
zipping around	the
zipping through	the
zipping up	his the her
zircon age	of
zircon and	apatite monazite
zircon from	the
zircon in	the
zirconium and	hafnium titanium
zirconium in	the
zircons from	the
zircons in	the
zlotys a	month
znanosti i	umjetnosti
zodiac and	the
zodiac in	the
zodiac is	a
zodiac of	the
zodiac on	the
zodiac sign	of
zodiacal light	is and
zodiacal sign	of
zodiacal signs	and
zona da	mata
zona fasciculata	and of
zona glomerulosa	of and cells is
zona pellucida	and of is in
zona reticularis	of
zonal and	meridional
zonal arrangement	of
zonal component	of
zonal distribution	of
zonal kinetic	energy
zonal pattern	of
zonal structure	of
zonal wave	number
zonal wind	stress in component
zonality of	the
zonation in	the
zonation of	the vegetation
zone A	and
zone B	cells
zone I	and
zone a	few
zone about	the
zone above	the
zone according	to
zone across	the
zone adjacent	to
zone affected	by
zone after	the
zone against	the
zone ahead	of
zone along	the which a
zone and	the a in to is its that then are on an of was for at thus also it by not into their has may from another therefore other with one can were have had there this continental all those so will as they
zone appears	to
zone are	the not also shown found in of very more
zone around	the a it
zone as	a the well an it shown in far defined
zone associated	with
zone at	the a least all about this any an which
zone axis	of
zone based	on
zone because	of the it
zone before	the
zone behind	the
zone below	the
zone beneath	the
zone between	the two them these a North
zone beyond	the
zone bordering	the
zone boundaries	are
zone boundary	is
zone bounded	by
zone but	also not the
zone by	the a means zone
zone called	the
zone can	be not also
zone caused	by
zone characterized	by
zone close	to
zone coincides	with
zone compared	to
zone composed	of
zone comprises	the
zone comprising	the
zone consisted	of
zone consisting	of
zone consists	of
zone containing	the a
zone contains	the a
zone contiguous	to
zone controlled	by
zone corresponding	to
zone corresponds	to
zone could	be not
zone covered	by
zone covers	the
zone created	by
zone de	la
zone defined	by
zone depends	on
zone did	not
zone do	not
zone does	not
zone dominated	by
zone down	to
zone due	to
zone during	the a
zone east	of
zone electrophoresis	in and of
zone employment	credit
zone established	by
zone extending	from to
zone extends	from to
zone filled	with
zone for	the a which each this an all
zone formed	by
zone forms	a
zone free	of from
zone from	the which a
zone had	been a to
zone has	been a the not its an to become
zone have	been a
zone having	a
zone i	to and
zone if	the
zone in	the which a Germany order this front Central an southern transition South Europe question northern central its terms between that North Fig accordance each Africa relation both eastern their one all Figure
zone includes	the
zone including	the
zone indicates	that
zone inhabited	by
zone inside	the
zone instead	of
zone into	the a which two
zone is	the a not characterized also an in to very about located that formed defined called of usually more shown found composed at one often much given determined marked generally only divided less present used represented considered known made still relatively well now created then reached small dominated seen limited situated approximately equal established assumed bounded probably quite covered always characterised where so almost thus clearly reduced therefore due indicated occupied being most too from between as similar likely narrow exposed completely based associated mainly controlled separated observed on taken required set
zone it	is was
zone just	below above
zone known	as
zone leads	to
zone lies	between in
zone lying	between
zone management	program programs in and
zone marked	by
zone may	be have not also extend
zone might	be
zone model	of
zone more	than
zone must	be have
zone near	the
zone next	to
zone north	of
zone not	only
zone occupied	by
zone occupies	the
zone occurs	in
zone of	the proximal a peace occupation influence transition Germany saturation high contact maximum operations privacy inhibition danger low interests aeration an indifference action this interest fire active interior growth fracture intense conflict weakness weathering oxidation light about secondary silence their provisional overlap small acceptance greatest injury accumulation increased its protection reasonableness safety West interaction deformation water Europe tolerance war flow southern attached activity each very our soil agreement mixed application potential one relatively thermal large northern North uncertainty fusion central normal France cell operation convergence South land separation higher necrosis partial his control complete hemolysis military possible most elongation lower origin cells these more rock free that Africa combustion India monetary constant calcification rapid highest stability junction responsibility western strong comfort some erythema avoidance vegetation tissue white dense primary Austria deep eastern Lake life intensive mixing which permanent security no cartilage two inflammation human reduced relative oil compression freedom any clear all calms polarizing development Central non another red variable economic concentration heavy uplifts combat advance lakes proliferation faulting such Nigeria disturbance fine tropical Morocco destruction wave intersection settlement both direct negative dark Western plastic forest twilight instability plants great reaction hyperemia coagulation cultural indistinction Lissauer flowage personal calcified shallow Rajasthan death intermediate surface sharp Sri cytoplasm highs pure air moderate deposition less alteration contamination continuous residence three tension production your precipitation demarcation crustal highly intergradation subsidence apposition sharpness political ablation root territory optimal greater varying maturation stasis perpetual
zone off	the
zone on	the a either both each
zone or	the in a on zones belt to area region
zone outside	the
zone over	the which a Bosnia
zone parallel	to
zone plate	is
zone prior	to
zone produced	by
zone ranges	from
zone rather	than
zone reaches	the
zone referred	to
zone refining	of
zone relative	to
zone represents	the a
zone results	in
zone rich	in
zone round	the
zone seems	to
zone separating	the
zone shall	be
zone should	be not have
zone shown	in
zone shows	a
zone similar	to
zone since	the
zone size	is and
zone so	that as
zone south	of
zone stretching	from
zone subject	to
zone such	as
zone surrounded	by
zone surrounding	the
zone system	of is
zone tends	to
zone than	in the
zone that	is the was has extends would can had are contains lies may will separates includes
zone there	is are was
zone they	are
zone through	the which a
zone throughout	the
zone to	the be another zone a which prevent protect form an include
zone together	with
zone toward	the
zone towards	the
zone under	the
zone until	the
zone up	to
zone using	the
zone varies	from
zone was	not the a to established found also in created formed observed about
zone we	have
zone were	not to
zone west	of
zone when	the it
zone where	the it they there a he we no
zone which	is was has extends are may had would lies includes can the
zone while	the
zone will	be have not
zone with	the a its an respect no
zone within	the which a
zone without	the a
zone would	be have not
zoned for	residential commercial single industrial business industry a the
zones A	and
zones B	and
zones I	and
zones II	and
zones above	the
zones according	to
zones across	the
zones adjacent	to
zones along	the
zones and	the in their to a other are is of that areas for on regions subzones then by also at localities
zones appear	to
zones are	not the also shown in found often located more present usually defined formed characterized of to used very recognized separated generally a established distinguished as given indicated based called represented marked considered being created areas
zones around	the them
zones as	well a the shown they follows in
zones associated	with
zones at	the a
zones away	from
zones based	on
zones because	of
zones below	the
zones between	the
zones beyond	the
zones but	also
zones by	the a
zones can	be not also
zones characterized	by
zones close	to
zones consist	of
zones controlled	by
zones correspond	to
zones corresponding	to
zones could	be
zones created	by
zones defined	by
zones did	not
zones do	not
zones does	not
zones due	to
zones during	the
zones established	by
zones for	the a each which
zones from	the which
zones had	been
zones has	been
zones have	been a the not
zones i	and
zones in	the which a Germany order this an each Europe China their various both terms different all these Africa other relation North
zones include	the
zones into	which the a
zones is	the not a to that shown also an
zones it	is
zones like	the
zones may	be have also
zones might	be
zones must	be
zones near	the
zones occupied	by
zones occur	in
zones of	the occupation influence high a Germany weakness different inhibition privacy vegetation peace low India conflict proximal transition contact this intense activity both Europe maximum control interest higher their growth these Africa equal North increased climate varying other military our an oil West action interaction two life coastal operation lower large light production active convergence necrosis land temperature all more latitude secondary deformation various South human water economic each relatively color increasing greater protection turmoil very strong northern development deep national tectonic compression greatest responsibility
zones on	the a either both
zones or	areas regions in the belts districts bands
zones outside	the
zones over	the
zones parallel	to
zones ranging	from
zones rather	than
zones referred	to
zones related	to
zones seem	to
zones separated	by
zones shall	be
zones should	be
zones shown	in
zones so	that
zones such	as
zones surrounding	the
zones tend	to
zones than	in
zones that	are have were the can had may would
zones there	is are
zones through	the which
zones throughout	the
zones to	the be which a
zones under	the
zones up	to
zones was	not
zones were	established not created to also found the
zones where	the they there it
zones which	are have were may can
zones will	be
zones with	the a different high their an
zones within	the which a
zones would	be have
zoning and	building subdivision other planning land the development
zoning as	a
zoning board	of to
zoning can	be
zoning classification	of
zoning does	not
zoning enabling	act acts legislation
zoning for	the
zoning has	been
zoning in	the a
zoning is	a not the to that
zoning laws	and to that are in
zoning may	be
zoning must	be
zoning of	the land a
zoning on	the
zoning or	other building
zoning ordinance	is and which was that in to of or may as for must has prohibiting will
zoning ordinances	and to that are in which or have were of
zoning plan	for
zoning power	to
zoning regulations	and to in are that of for which
zoning restrictions	on and
zoning should	be
zoning would	be
zonule of	Zinn
zoo and	the a aquarium
zoo animals	and
zoo as	a
zoo at	the
zoo for	the
zoo in	the a
zoo is	a open the
zoo of	the
zoo on	the
zoo or	a the
zoo to	see
zoo with	a
zoogeography of	the
zooids of	the
zoological and	botanical
zoological garden	in
zoological gardens	and in of
zoological or	botanical
zoological point	of
zoologist and	botanist
zoologist at	the
zoologist of	the
zoologists and	botanists
zoologists of	the
zoology and	botany geology comparative the physiology entomology
zoology at	the
zoology from	the
zoology in	the
zoology of	the
zoology or	botany
zoom and	pan
zoom back	out
zoom in	on and to or for the
zoom into	the a
zoom lens	is and to on with that for
zoom lenses	are
zoom of	the
zoom on	the
zoom out	to of and
zoom through	the
zoom to	the a
zoomed across	the
zoomed around	the
zoomed down	the
zoomed in	on to for and
zoomed into	the
zoomed out	of
zoomed over	the
zoomed through	the
zoomed to	the
zoomed up	to
zooming and	panning
zooming around	the
zooming down	the
zooming in	on and to or
zooming into	the
zooming through	the
zoomorphic and	anthropomorphic
zooms in	on to and
zooplankton and	phytoplankton fish the
zooplankton biomass	in and
zooplankton community	structure
zooplankton in	the a
zooplankton of	the
zoos and	aquariums circuses museums
zoos around	the
zoos in	the
zoospores of	the
zoot suit	riots
zoster and	herpes
zoster immune	globulin
zoster in	the
zoster is	a
zoster may	be
zoster of	the
zoster virus	infection infections in and is
zu Anfang	des
zu Beginn	des der
zu Ehren	von
zu Ende	des
zu Fragen	der
zu Frankfurt	am
zu Grunde	liegen
zu Gunsten	der
zu Holderlins	Dichtung
zu Leben	und
zu allen	Zeiten
zu beiden	Seiten
zu beobachten	ist
zu betrachten	ist sind
zu bringen	und
zu dem	Ergebnis Schluss der
zu den	anderen einzelnen Kinder Schriften Quellen beiden Juden in ersten Anfangen verschiedenen
zu der	Annahme Zeit Frage von
zu diesem	Zeitpunkt Zweck Thema Zwecke
zu dieser	Zeit
zu einem	gewissen neuen bestimmten der anderen Zeitpunkt
zu einer	Theorie reinen neuen Geschichte allgemeinen Zeit Kritik Art Philosophie bestimmten anderen solchen jeden Kategorie der
zu erhalten	und
zu erkennen	ist und
zu ersehen	ist
zu erwarten	ist war
zu finden	sind ist und
zu gleicher	Zeit
zu haben	und scheint
zu halten	und
zu ihrer	Geschichte
zu jeder	Zeit
zu jener	Zeit
zu lassen	und
zu machen	und
zu nehmen	und
zu rechnen	ist
zu sehen	ist und sind
zu sein	scheint und scheinen als
zu seiner	Zeit
zu sich	selbst
zu suchen	ist
zu tun	haben hat
zu verschiedenen	Zeiten
zu verstehen	ist und
zu werden	und
zucchini and	cook
zucchini in	a
zucchini is	tender
zucchini yellow	mosaic
zugleich ein	Beitrag
zum Alien	Testament
zum Alten	Testament und
zum Anfang	des
zum Ausbruch	des
zum Ausdruck	kommt gebracht bringen bringt kommen zu
zum Ausgang	des der
zum Beginn	des der
zum Begriff	der
zum Beispiel	die in der
zum Ende	des der
zum Ersten	Weltkrieg
zum Nachweis	von
zum Neuen	Testament
zum Problem	der des
zum Schutz	der des
zum Schutze	der des
zum Stand	der
zum Studium	der des
zum Teil	auch in
zum Verhaltnis	von
zum Verstandnis	der des
zum Zeitpunkt	der
zum Zweck	der
zum Zwecke	der
zum einen	die
zum ersten	Mal Male Mai
zum grossen	Teil
zum sechzigsten	Geburtstag
zum siebzigsten	Geburtstag
zuppa di	pesce
zur Abwehr	des
zur Allgemeinen	und
zur Analyse	der des von
zur Anatomie	und der des
zur Aufnahme	der
zur Beforderung	der
zur Begutachtung	der
zur Behandlung	der von
zur Bekampfung	der
zur Berechnung	der von
zur Beschreibung	der von
zur Bestimmung	der des von
zur Beurteilung	der
zur Bildung	der von
zur Biologie	der und
zur Chronologie	der
zur Darstellung	der des
zur Deutung	der
zur Einfiihrung	in
zur Einfuhrung	in
zur Einleitung	in
zur Englischen	Philologie
zur Entstehung	der des und
zur Entstehungsgeschichte	der
zur Entwicklung	der des von
zur Entwicklungsgeschichte	der des
zur Erfassung	der
zur Erforschung	der des
zur Erinnerung	an
zur Erklarung	der
zur Erlangung	der des
zur Ermittlung	der
zur Erzeugung	von
zur Feier	des
zur Feststellung	der
zur Folge	haben hat
zur Forderung	der des
zur Frage	der des nach
zur Funktion	der
zur Geistesgeschichte	des
zur Geologie	der
zur Geschichte	der des und von Israels
zur Grundlegung	der
zur Hausen	H
zur Herstellung	von
zur Kenntnis	der des
zur Kenntniss	der des
zur Kentniss	der
zur Kritik	der des
zur Kulturgeschichte	des
zur Kunde	des
zur Kunst	des
zur Lage	der
zur Lehre	von vom
zur Literatur	und
zur Losung	der
zur Messung	der des
zur Metaphysik	der
zur Methodik	der
zur Mitte	des
zur Morphologie	und der
zur Musikgeschichte	des
zur Naturgeschichte	der
zur Pathogenese	der
zur Pathologie	der des und
zur Philosophic	der
zur Philosophie	der und des
zur Physik	der
zur Physiologie	der des und
zur Politik	und
zur Psychologie	der des
zur Reform	der des
zur Religion	und
zur Sicherung	der
zur Sozialgeschichte	der
zur Soziologie	und des der
zur Sprache	und
zur Statistik	des der
zur Steigerung	der
zur Struktur	der und
zur Systematik	der
zur Theologie	des der
zur Theorie	der des und
zur Untersuchung	der des von
zur Verbesserung	der des
zur Vorgeschichte	des der
zur Wahrung	der
zur Wissenschaft	vom
zur Wochenzeitung	Das
zur Zeit	der des
zur Zeitschrift	fur
zur alten	Geschichte
zur brandenburgischen	und
zur deutschen	Literatur Geschichte Kunstgeschichte Sprache
zur englischen	Philologie
zur evangelischen	Theologie
zur gleichen	Zeit
zur historischen	Theologie
zur klassischen	Philologie
zur neueren	Geschichte
zur pathologischen	Anatomie
zur rechten	Zeit
zur romanischen	Philologie
zur selben	Zeit
zur vergleichenden	Anatomie
zusammen mit	dem der den
zwar in	der
zwar nicht	nur
zwei Arten	von
zwei bis	drei
zwei oder	drei mehr
zweiten Halfte	des
zweiten und	dritten
zwischen Deutschland	und
zwischen Gott	und
zwischen Kirche	und
zwischen Mensch	und
zwischen Ost	und
zwischen Reform	und
zwischen Revolution	und
zwischen Schiller	und
zwischen Staat	und
zwischen Tradition	und
zwischen dem	Deutschen
zwischen den	beiden einzelnen verschiedenen zwei
zwischen der	Bundesrepublik
zwischen diesen	beiden
zwischen ihm	und
zygapophyseal joint	pain
zygoma and	the
zygoma to	the
zygomatic arch	and is to in
zygomatic arches	are and
zygomatic bone	and is
zygomatic branch	of
zygomatic process	of and is
zygomatic processes	of
zygomaticus major	and
zygote and	the
zygote develops	into
zygote in	the
zygote intrafallopian	transfer
zygote is	formed the a
zygote to	the
zygotic embryos	of
zymogen granules	in and
zzril delenit	augue
