X A	X A B CIP
X AND	Y
X All	rights
X As	Single Integer
X B	is
X CO	CO
X Company	as
X Corporation	is stock has and in for
X Corps	was and in to had
X Do	not
X Edited	by
X First	published
X For	the
X How	to
X I	I X have
X IN	THE
X If	the
X In	the this
X It	is was
X Library	of
X Manufactured	in
X Marks	the
X Master	e
X Microsoft	Excel
X New	York
X Number	of
X O	O
X On	the
X Paired	against
X Printed	in
X Published	by
X Rays	and
X S	X
X See	the
X The	powers
X There	is
X This	is book
X Toolkit	Intrinsics
X Window	System system
X X	X x XXX XX o A I The s Figure Table O New a V No Y and
X XI	XII
X XX	X XX XXX
X XXX	X XXX
X Y	Z z and X Company
X a	X
X about	the
X according	to
X across	the
X after	the
X against	the
X agrees	to
X along	the
X amount	of
X and	Y the Z XI a X Theory R V y one his A its is T then that XII B F of S P in I M not an to O W for C Martin n s other K x Clement p all L are gamma N it D XIII H U u theory so let two E t also at some on by their The v any if hence we less with another others no which thus Windows Q therefore her XVI
X appears	in to
X are	the not given in also Y shown all
X as	a the an well follows long in shown its it
X associated	with
X at	the a time which all t
X axis	and is of in to at represents
X based	on
X be	a the an any
X because	of it the he
X before	the
X being	the a
X believes	that
X belongs	to
X between	the
X but	not
X by	the a means
X came	to
X can	be not take also only
X causes	Y
X chromosome	and is in of from inactivation that are to with has was or may will which at can carries carrying
X chromosomes	in and are of is to from
X common	stock
X component	of
X consists	of
X contains	the a
X coordinate	of
X corresponding	to
X corresponds	to
X could	be not have
X counts	as
X defined	by
X denote	the
X denotes	the a
X depends	on
X did	not
X direction	and is
X divided	by
X do	not
X does	not
X due	to
X during	the
X el	Sabio
X equal	to the
X equals	the
X et	al
X followed	by
X for	the a which each Y all any an this
X from	the a Y its
X g	for
X given	by
X gives	the a
X greater	than
X had	been a not no to the
X has	a been the an no to not two
X have	been a the
X his	mark
X if	the and it he you
X in	the a this Fig terms Figure order his which each an one its front A that it Eq exchange any such equation our all some
X inactivation	in
X indicates	that the a
X instead	of
X into	the a Y
X is	the a not an in given to defined called equal Y less true good said any used also greater of more known that then one normally now very zero determined found at positive A some small either obtained shown assumed always measured related on present negative approximately taken right as normal usually set denoted constant increased for made only still expressed independent large placed no considered better produced replaced associated just required based represented distributed therefore about so being between simply finite chosen much such connected calculated equivalent like proportional X located entitled wrong fixed continuous assigned often identical thus larger actually Z F its added all treated false compact non likely smaller discrete
X it	is
X knows	that
X la	Mode
X leads	to
X length	of
X less	than
X lies	in between
X light	chains chain
X m	matrix
X made	a
X makes	a
X marks	the
X may	be have not also
X means	that
X mental	retardation
X might	be have
X must	be have
X n	matrix
X need	not
X next	to
X nor	Y
X number	of
X o	o X
X occurs	in
X of	the Castile a this France The his Sweden Total an all total Y
X on	the Y a it his each one
X operating	system
X or	Y a the Z X gamma an to not O Theory
X ought	to
X out	of
X over	the
X per	cent unit
X percent	of
X provides	a
X rather	than
X ray	of and is diffraction or to was in showed
X rays	and are of in to were or from is can by on have that for showed with may taken as at was emitted will produced had show
X refers	to
X relative	to
X represent	the
X represents	the a an
X results	in
X s	X s
X said	that
X satisfies	the
X says	that
X scale	factor
X seems	to
X server	and to is
X sex	chromosome
X shall	be
X should	be not have
X shows	the that
X so	that
X stand	for
X stands	for
X stock	to
X such	that
X syndrome	is and in
X takes	on the
X tend	to
X tends	to
X than	in
X that	is the are he can has it
X the	wavelength number wave
X there	is
X through	the
X times	the
X to	the be Y a X do A have Z make represent B indicate obtain an get its cut XII which
X together	with
X under	the
X units	of
X up	to
X using	the
X value	of is
X values	are in and for of
X variable	is
X variables	are
X wants	to
X was	a the not in an to assassinated found born
X we	have can
X were	to not
X when	the he
X where	the X
X which	is are has
X who	is
X will	be not have do
X window	system
X wishes	to
X with	the a respect an Y
X within	the
X would	be have not
X x	X x Y
X y	z
XA and	XB
XA is	the
XANES spectra	of
XHTML and	CSS
XI In	the
XI International	Conference Congress
XI XII	XIII
XI and	XII the XIII Pius Charles his XIV
XI did	not
XI e	XII
XI for	the
XI gives	the
XI in	the his
XI is	a the
XI of	the France this Sweden The Castile his
XI on	the
XI shows	the that
XI to	the
XII In	the
XII International	Congress
XII XIII	XIV
XII and	XIII the XIV his Francis XV
XII at	the
XII did	not
XII e	XIII
XII for	the
XII gives	the
XII had	been
XII in	the his
XII is	a
XII of	the Sweden France this The his
XII on	the
XII shows	the that
XII to	the
XIII International	Congress
XIII It	was
XIII XIV	XV
XIII and	XIV the Pius his Louis Richelieu XV
XIII e	XIV
XIII for	the
XIII in	the his
XIII of	the France Spain this
XIII on	the
XIII shows	the
XIII to	the
XIIe et	XIIIe
XIV International	Congress
XIV Panzer	Corps
XIV XV	XVI
XIV and	XV the his Louis Napoleon Colbert XVI of
XIV as	a the
XIV at	Versailles the
XIV did	not
XIV e	XV
XIV et	XV
XIV for	the
XIV had	been
XIV in	the France his
XIV of	France the this Sweden
XIV on	the
XIV revoked	the
XIV shows	the
XIV that	the
XIV to	the
XIV was	the a not
XIV with	the
XIV would	have
XIVe et	XVe
XIX Tactical	Air
XIX XX	XXI
XIX and	XX
XIX i	XX
XIX of	the GATT
XIX y	XX
XIXe et	XXe
XIXth to	XXXth
XL and	Xc
XL is	the
XL of	the
XLI Panzer	Corps
XLVII Panzer	Corps
XLVIII Panzer	Corps
XM Satellite	Radio
XML Document	Object
XML Information	Set
XML Key	Management
XML Metadata	Interchange
XML Path	Language
XML Query	Language
XML Schema	Definition is Part and document for specification to
XML Web	service services Services Service
XML and	the HTML XSL Web XSLT SOAP Java XML its
XML as	a the
XML can	be
XML configuration	file files
XML data	in type is into and to from file source that using
XML deployment	descriptor
XML dialog	box
XML document	is that and to in into with as can using from or must for containing by has object contains
XML documents	and are that in to can into with using is as from for
XML does	not
XML elements	and
XML file	that and is to in with into containing for as
XML files	that are and
XML for	the
XML format	for and
XML from	the a
XML has	been
XML in	the a
XML is	a not the used an that to
XML on	the
XML provides	a
XML representation	of
XML schema	for and is to
XML to	the HTML
XML web	services service
XOR gate	is
XOR of	the
XORed with	the
XP For	Dummies
XP Home	Edition
XP Media	Center
XP Professional	and computer is or operating Edition
XP Service	Pack
XP Tablet	PC
XP and	Windows the Vista
XP comes	with
XP displays	the
XP does	not
XP has	a
XP includes	a
XP is	a the
XP operating	system
XP or	Windows
XPS analysis	of
XPS and	AES
XPS spectra	of
XPS spectrum	of
XPath expression	that
XRD analysis	of
XRD pattern	of
XRD patterns	of for
XRD spectra	of
XSL Formatting	Objects
XSL style	sheet
XSLT and	XPath
XSLT is	a
XSLT style	sheet
XT and	AT
XT or	AT
XV III	Century
XV International	Congress
XV XVI	XVII
XV and	XVI Louis the his XVII
XV e	XVI
XV in	the
XV of	the France this
XV on	the
XV shows	the
XV to	the
XV y	XVI
XVI Carved	and
XVI Ith	century
XVI XVII	XVIII
XVI and	XVII Marie his the XVIII
XVI e	XVII
XVI had	been
XVI i	XVII
XVI in	the
XVI of	the France this
XVI on	the
XVI shows	the
XVI to	the
XVI was	executed a
XVI y	XVII
XVII XVIII	XIX
XVII and	XVIII XIX
XVII e	XVIII
XVII i	XVIII
XVII of	the this
XVII shows	the
XVII y	XVIII
XVIII Airborne	Corps
XVIII Century	Oblong With
XVIII XIX	XX
XVIII and	XIX Charles the
XVIII e	XIX
XVIII of	the France this
XVIII shows	the
XVIII to	the
XVIII y	XIX
XVIIIe et	XIXe
XVIIIth and	XlXth
XVIIe et	XVIIIe au
XVIIth and	XVIIIth
XVIe au	XVIIIe
XVIe et	XVIIe
XVIth and	XVIIth
XVe et	XVIe
XVth International	Congress
XVth and	XVIth
XX Bomber	Command
XX Valeria	Victrix
XX X	X XX
XX XX	XX X XXX
XX XXI	XXII
XX XXX	XXX XX
XX and	XXI XY the YY
XX in	the
XX is	the a
XX of	the GATT
XX or	XY
XXI Bomber	Command
XXI XXII	XXIII
XXI and	XXII
XXI of	the
XXII XXIII	XXIV
XXII and	XXIII
XXII of	the
XXIII and	XXIV the Paul
XXIII in	the
XXIII of	the GATT
XXIII to	the
XXIV Panzer	Corps
XXIV and	XXV
XXIV of	the GATT
XXIX and	XXX
XXIX of	the
XXV and	XXVI
XXV of	the
XXVI XXVII	XXVIII
XXVI and	XXVII
XXVI of	the
XXVII XXVIII	XXIX
XXVII and	XXVIII
XXVII of	the
XXVIII and	XXIX
XXVIII of	the
XXX X	X XXX
XXX XX	XX X XXX
XXX XXX	XXX X XX
XXX and	XXXI
XXX of	the
XXXI and	XXXII
XXXI of	the
XXXII and	XXXIII
XXXII of	the
XXXIII and	XXXIV
XXXIII of	the
XXXIV and	XXXV
XXXIV of	the
XXXV and	XXXVI
XXXV of	the
XXXVI and	XXXVII
XXXVI of	the
XXXVII and	XXXVIII
XXXVIII and	XXXIX
XXXX XXXX	XXXX
XXXXX XXXXX	XXXXX
XY and	the
XY gonadal	dysgenesis
XY in	the
XY is	the
XY plane	of and
XYY and	XXY
XYZ Company	is as has
XYZ Corporation	is
XYZ is	a
Xa and	Xb
Xa is	the
Xanadu did	Kubla
Xanthomonas campestris	pv
Xavier Cugat	and
Xavier High	School
Xavier Institute	of
Xavier University	in of
Xavier and	his the
Xavier de	Maistre Charlevoix
Xavier del	Bac
Xavier did	not
Xavier had	been
Xavier in	the
Xavier was	a
Xc is	the
Xe and	Kr
Xe in	the
XeCl excimer	laser
Xenophanes of	Colophon
Xenophobia and	Related
Xenophon and	Plato the his
Xenophon does	not
Xenophon in	his the
Xenophon of	Ephesus
Xenophon says	that
Xenophon tells	us
Xenophon was	a
Xenopus egg	extracts
Xenopus laevis	oocytes and embryos oocyte
Xenopus oocytes	and
Xeres de	la
Xerox College	Publishing
Xerox Corporation	and in
Xerox Education	Publications Company
Xerox Network	System Systems
Xerox PARC	and
Xerox Palo	Alto
Xerox University	Microfilms
Xerox and	Fuji
Xerox copies	of
Xerox copy	of
Xerox in	the
Xerox is	a
Xerox of	the
Xerxes and	his the Darius
Xerxes in	the his
Xerxes invaded	Greece
Xerxes the	Great
Xerxes to	the
Xew York	City and
Xg blood	group
Xhosa and	Zulu the
Xhosa in	the
Xi Psi	Phi
Xi and	the Xj Xi X
Xi are	the
Xi be	the
Xi can	be
Xi in	the
Xi is	the a
Xi of	the
Xia et	al
Xiamen Special	Economic
Xiang et	al
Xiao et	al
Xiaoping and	his the other
Xiaoping in	the
Xie et	al
Xieng Khouang	Province
Ximenes de	Cisneros
Ximenez de	Cisneros
Xin Tang	shu
Xin et	al
Xing et	al
Xingu National	Park
Xinhua Domestic	Service
Xinhua News	Agency
Xinhua news	agency
Xinjiang Autonomous	Region
Xinjiang Uighur	Autonomous
Xinjiang Uyghur	Autonomous
Xinjiang Uygur	Autonomous
Xinjiang and	the Tibet
Xinjiang in	the
Xiong et	al
Xj and	the
Xj in	the
Xj is	the a
XlVe et	XVe
XlVth International	Congress
XlVth and	XVth
XlXth and	XXth
Xle et	Xlle
Xllth International	Congress
Xlth International	Congress
Xm is	the
Xn is	the
Xo is	the
Xp is	the
Xs and	Os Ys
Xs are	Ys not
Xs in	the
Xs is	the
Xs on	the
Xt John	H
Xt and	Yt
Xt is	the a
Xth International	Congress
Xu et	al
Xue et	al
Xunta de	Galicia
Xylem and	phloem
x As	Integer Single
x B	drift is interaction and x
x E	interaction
x If	the
x In	the this
x It	is was
x LIST	OF
x List	of
x M	matrix
x N	matrix matrices
x Number	of
x On	the
x Rate	x
x SSC	at
x Sex	x
x There	is
x This	is
x United	States
x X	X x
x a	m x
x above	the
x according	to
x after	the
x along	the
x amount	of
x and	y the z x a v t is p s then its time R that of xi u for in n r A X to an b not w f one Y all at and are we The m e T k any j so it c i with standard hence cos h o d which therefore P if on by can I thus let variance q B
x andy	are
x appears	in
x approaches	zero a the infinity
x are	the not given in shown
x area	of
x as	a the an long well follows in shown its
x at	the time a which t any
x axis	is and of at in to with as are for represents from by
x based	on
x be	the a an any
x being	the a
x believes	that
x belonging	to
x belongs	to
x below	the
x between	the
x body	weight
x but	not
x by	the a y means using an
x can	be not take assume
x causes	y
x changes	from
x close	to
x component	of
x components	of
x consists	of
x coordinate	of is and
x coordinates	of
x corresponding	to
x corresponds	to
x cos	x
x could	be
x defined	by
x denote	the
x denotes	the a
x dependence	of
x depends	on
x direction	and is with in at of as are for to
x distance	from
x divided	by
x do	not
x does	not
x due	to
x during	the
x e	X A S R
x environment	interaction interactions
x equal	to the
x equals	the
x followed	by
x for	the which a all each any x y every this an
x from	the a its one A
x g	for supernatant and at in to
x given	by
x gives	the
x glioma	hybrid
x goes	to
x greater	than
x has	a the been an to no
x have	been the
x if	and the it
x in	the a diameter terms this Fig A each X an equation order Eq Figure length which S some its one that G any Equation
x increases	from by
x indicates	the that
x instead	of
x into	the a
x is	the a an not in given equal greater less to defined called measured positive any negative small used also zero of true said found replaced at obtained known then identical F determined very between one taken good large always y such A increased now proportional shown more red related approximately chosen constant assigned expressed either normally assumed denoted that distance mortal on represented some set written larger made preferred human independent x calculated present equivalent as close therefore usually considered changed simply just only fixed bound much smaller real The divided even about its better free no from so plotted where P part observed divisible computed still different multiplied normal associated
x it	is
x k	matrix
x leads	to
x length	of
x less	than
x lies	between in
x m	matrix
x may	be have
x means	that
x might	be
x moles	of
x multiplied	by
x must	be have
x n	matrix matrices and identity array
x nor	y
x number	of
x occurs	in
x of	the a this an type X length
x on	the y a
x or	y the a x z more
x ought	to
x out	of
x over	the y
x p	matrix
x parallel	to
x per	cent unit
x percent	of
x position	of
x r	matrix
x raised	to
x ranges	over
x ranging	from
x rather	than
x rays	and are in of is or from to by
x refers	to
x relative	to
x replaced	by
x represent	the
x representing	the
x represents	the a
x results	in
x satisfies	the
x satisfying	the
x should	be
x so	that
x specific	heat
x stand	for
x stands	for
x successes	in
x such	that
x takes	on the
x tends	to
x that	is are the satisfies will satisfy has it
x the	distance number value
x then	the
x there	is
x through	the
x time	interaction
x times	the
x to	the be y a x represent obtain have get an denote z which
x treatment	interaction
x under	the
x units	of
x up	to
x using	the
x value	of is for and
x values	are and of in for is
x varies	from
x volume	of
x was	the a
x we	have can obtain
x when	the y
x where	the x
x which	is are has can satisfies will
x width	x of
x will	be have not
x with	the respect a an probability y
x within	the
x would	be have
x x	x X The I
x y	z
x years	after of old
xA and	xB
xa and	xb
xa is	the
xanthine and	hypoxanthine
xanthine dehydrogenase	to
xanthine oxidase	and activity in inhibitor is system
xanthine to	uric
xanthomatous biliary	cirrhosis
xc is	the
xe is	the
xenobiotic metabolism	in
xenobiotic metabolizing	enzymes
xenobiotics in	the
xenografts in	nude
xenoliths from	the
xenoliths in	the
xenoliths of	the
xenon and	krypton
xenon arc	lamp lamps
xenon flash	lamp
xenon in	the
xenon light	source
xenophobia and	racism anti related the
xenophobia in	the
xenophobia of	the
xenophobic and	racist anti
xeroderma pigmentosum	and cells group
xerographic print	of
xerographic process	on
xerographically in	this
xerography on	acid
xerosis of	the
xerox copies	of
xerox copy	of
xi About	the
xi Acknowledgments	xiii xv
xi CHAPTER	I
xi Chapter	One
xi Foreword	by
xi Introduction	xiii
xi LIST	OF
xi List	of
xi Note	on
xi PART	I ONE
xi Part	I One
xi Preface	xiii to
xi Table	of
xi and	xii the xj yi x xi
xi in	the
xi is	the a
xi of	the
xii LIST	OF
xii List	of
xii and	xiii
xii of	the
xiii About	the
xiii Acknowledgments	xv
xiii CHAPTER	I ONE
xiii Chapter	One
xiii Introduction	xv
xiii LIST	OF
xiii List	of
xiii PART	I ONE
xiii Part	I One
xiii Preface	to xv
xiii Table	of
xiii and	xiv
xiii of	the
xiphoid process	and of to is
xiv LIST	OF
xiv List	of
xiv and	xv
xiv of	the
xix List	of
xix PART	I
xix and	xx
xj is	the
xk is	the
xl of	the
xm and	the
xm in	diameter length the
xm is	the
xm of	the
xml data	type
xn is	the
xn of	the
xo is	the
xp is	the
xs is	the
xt and	yt the
xt in	the
xt is	the a
xt of	the
xv About	the
xv List	of
xv PART	I ONE
xv Part	I
xv and	xvi
xv of	the
xvi List	of
xvi and	xvii
xvi of	the
xvii About	the
xvii List	of
xvii PART	I ONE
xvii Part	I One
xvii Table	of
xvii and	xviii
xviii and	xix
xx and	xxi
xx is	the
xx of	the
xxx is	the
xxx xxx	xxx
xxxx xxxx	xxxx
xxxxx xxxxx	xxxxx
xxxxxx xxxxxx	xxxxxx
xxxxxxx xxxxxxx	xxxxxxx
xxxxxxxx xxxxxxxx	xxxxxxxx
xxxxxxxxx xxxxxxxxx	xxxxxxxxx
xxxxxxxxxx xxxxxxxxxx	xxxxxxxxxx
xy coordinate	system
xy is	the
xy plane	and is of with
xylem and	phloem the
xylem in	the
xylem of	the a
xylem or	phloem
xylem parenchyma	cells
xylem sap	of
xylem to	the
xylem vessels	and of
xylene and	mount
xylene cyanol	FF
xylene in	the
xylene or	toluene
xylol and	mount
xylose absorption	test
xylose and	arabinose
xylose in	the
xyz coordinate	system
xz and	yz
