X All rights	reserved
X Company as	of
X First published	in
X Library of	Congress
X Manufactured in	the
X Marks the	Spot
X Printed in	the
X The powers	not
X Window System	is and
X X X	X x XXX XX o A I The Table
X X XX	X
X X XXX	X XXX
X X x	X x
X XI XII	XIII
X XX X	X
X XXX X	X
X Y z	A
X according to	the
X amount of	dollars
X and Clement	VII
X and Martin	Luther
X and R	charts
X and Theory	Y
X and V	factors
X and XI	of
X and Y	are is chromosomes axes in coordinates and have be values directions to can as will were that for of may respectively variables with axis represent at must on components would which by scores chromosome from the cells coordinate both positions denote each do such position should
X and Z	are axes
X and a	Y
X and in	the
X and one	Y
X and the	Y other Black
X and y	are
X appears in	the
X as a	function
X as long	as
X as well	as
X at the	end
X at time	t
X axis and	the
X axis is	the
X axis of	the
X be a	random set
X be the	number set
X by means	of
X can be	obtained any written found used expressed determined calculated
X can not	be
X chromosome and	the one a
X chromosome from	the their
X chromosome in	the a
X chromosome of	the Drosophila
X chromosome with	the
X chromosomes in	the
X chromosomes of	the
X component of	the
X coordinate of	the
X corresponding to	the
X corresponds to	the
X denote the	number
X depends on	the
X does not	have
X for which	the
X has a	right normal
X has the	same
X has to	be
X if and	only
X in exchange	for
X in front	of
X in order	to
X in terms	of
X in the	box upper appropriate first same following
X indicates that	the
X is a	random vector constant set function variable normal member good continuous subset discrete halogen finite positive matrix
X is associated	with
X is assumed	to
X is based	on
X is better	than
X is called	the a
X is defined	as by
X is denoted	by
X is determined	by
X is entitled	to
X is equal	to
X is equivalent	to
X is given	by
X is greater	than
X is in	the
X is independent	of
X is less	than
X is normally	distributed
X is not	a the Y an
X is of	the
X is on	the
X is one	of
X is proportional	to
X is related	to
X is replaced	by
X is represented	by
X is said	to
X is shown	in
X is the	wavelength number mean wave same set distance average vector total value sum case only decay ratio independent amount sample
X is to	be
X is used	to
X marks the	spot
X may be	a
X must be	a
X next to	the
X number of	dollars years
X o o	o
X of the	Bankruptcy Constitution Covenant Public Treaty League Act
X on the	line
X or Y	chromosome is or axis chromosomes
X or a	Y
X or the	Y
X ought to	be
X percent of	the
X ray of	the
X rays and	gamma the other
X rays are	produced
X rays can	be
X rays from	the
X rays in	the
X rays of	the
X refers to	the
X so that	the
X stands for	the
X such that	the
X the number	of
X there is	a
X to Y	is and
X to be	the a
X where X	is
X will be	the
X will not	be
X with respect	to
X would not	be
X x X	X
X x x	x
XI International Conference	on
XI International Congress	of
XI XII XIII	XIV
XI and Pius	XII
XI and XII	of
XI of the	Charter Convention Bankruptcy Treaty United Constitution Act
XII International Congress	of
XII and XIII	of
XII and the	Third
XII of the	Constitution Charter
XIII International Congress	of
XIII and Louis	XIV
XIII and Pius	XI
XIII of the	Treaty Constitution
XIV International Congress	of
XIV XV XVI	XVII
XIV and Louis	XV
XIV of France	and
XIV of the	Constitution
XIV revoked the	Edict
XIX XX XXI	XXII
XIX i XX	wieku
XIX of the	Social GATT
XIXe et XXe	siecles
XIXth to XXXth	Dynasties
XML Document Object	Model
XML can be	used
XML document as	a
XML document can	be
XML document into	a
XML document that	is contains
XML document to	be
XML documents can	be
XML representation of	the
XP Media Center	Edition
XP Professional and	Home
XP Professional operating	system
XP and Windows	Server
XPS spectra of	the
XRD pattern of	the
XRD patterns of	the
XV International Congress	of
XV XVI XVII	XVIII
XV and Louis	XVI
XVI XVII XVIII	XIX
XVI and Marie	Antoinette
XVI and his	family
XVI of the	Covenant Social
XVII XVIII XIX	XX
XVII and XVIII	centuries Centuries
XVIII XIX XX	XXI
XVIII and Charles	X
XVIII of the	Social
XVIIe et XVIIIe	siecles
XVIIth and XVIIIth	Dynasties
XVIe et XVIIe	siecles
XVe et XVIe	siecles
XVth International Congress	of
XX X X	X
XX XX XX	XX
XX of the	Social GATT
XXII and XXIII	of
XXIII and Paul	VI
XXIV of the	GATT
XXX X X	X
XXX XXX X	X
XXX XXX XXX	XXX
XXXX XXXX XXXX	XXXX
XXXXX XXXXX XXXXX	XXXXX
XY plane of	the
Xanadu did Kubla	Khan
Xavier University in	New
Xavier University of	Louisiana
Xenophobia and Related	Intolerance
Xenophon tells us	that
Xeres de la	Frontera
Xerox Palo Alto	Research
Xerox copies of	the
Xerox copy of	the
Xiamen Special Economic	Zone
Xinjiang Uighur Autonomous	Region
Xinjiang Uygur Autonomous	Region
XlVe et XVe	siecles
XlVth and XVth	Centuries
Xlth International Congress	of
Xt John H	Newman
Xth International Congress	of
x LIST OF	FIGURES
x List of	Tables Figures
x X X	X
x a m	C
x according to	the
x and R	charts
x and a	y
x and of	the
x and standard	deviation
x and t	are
x and the	y other second
x and time	t
x and v	are
x and x	are is
x and y	are directions axes coordinates in components is and values of as be to can have for respectively that direction represent will may which with by must axis from the such variables coordinate denote were at on positions dimensions being co if position only we would into both
x and z	are directions axes
x as a	function
x as long	as
x as shown	in
x as well	as
x at time	t
x at which	the
x axis and	the
x axis in	the
x axis is	the
x axis of	the
x axis to	the
x be the	number distance
x belongs to	the
x by means	of
x can be	obtained written expressed found calculated determined any
x can not	be
x component of	the velocity momentum
x components of	the
x coordinate of	the
x corresponding to	the
x corresponds to	the
x denote the	number
x depends on	the
x direction and	the
x direction with	a
x does not	occur exist have
x due to	the
x equal the	number
x for a	given
x for which	the f
x from the	left origin center surface centre axis end
x has a	value
x has the	property value same
x has to	be
x if and	only
x in order	to
x in terms	of
x in the	equation interval domain range first second direction original following expression above
x is a	variable vector man member function random positive number constant real person point solution
x is an	integer element n instance
x is assumed	to
x is at	least
x is called	the a
x is close	to
x is defined	as by
x is denoted	by
x is determined	by
x is equal	to
x is equivalent	to
x is expressed	in
x is given	by
x is greater	than
x is identical	with
x is in	the meters
x is increased	by
x is independent	of
x is larger	than
x is less	than
x is measured	from in
x is normally	distributed
x is not	a in an the
x is obtained	by
x is of	the
x is on	the
x is one	of
x is preferred	to
x is proportional	to
x is related	to
x is replaced	by
x is represented	by
x is said	to
x is shown	in
x is smaller	than
x is such	that
x is the	distance number mean same amount displacement vector value coordinate independent average position length horizontal fraction thickness time concentration input variable mole total sample ratio only sum state set quantity angle
x is to	be the
x is used	to
x is very	small
x lies in	the
x must be	a
x n identity	matrix
x n matrix	A of with and
x number of	years
x on the	left
x or y	is axis direction or
x per cent	of
x percent of	the
x raised to	the
x refers to	the
x represent the	number
x represents the	number
x so that	the
x stands for	the
x successes in	n
x such that	x the for
x the distance	from of
x the number	of
x the value	of
x there is	a
x to be	the a
x to represent	the
x to the	right
x to y	and is
x where x	is
x width x	height
x will be	the
x with respect	to
x x X	X
x x x	x X
xanthine to uric	acid
xenografts in nude	mice
xenophobia and related	intolerance
xerographic print of	this
xerographic process on	acid
xerographically in this	copy
xerox copy of	the
xi LIST OF	FIGURES
xi List of	Tables Abbreviations Figures
xi Preface to	the
xiii List of	Abbreviations Tables
xiii Preface to	the
xiphoid process and	the
xiphoid process of	the
xiphoid process to	the
xxx xxx xxx	xxx
xxxx xxxx xxxx	xxxx
xxxxx xxxxx xxxxx	xxxxx
xxxxxx xxxxxx xxxxxx	xxxxxx
xxxxxxx xxxxxxx xxxxxxx	xxxxxxx
xxxxxxxx xxxxxxxx xxxxxxxx	xxxxxxxx
xxxxxxxxxx xxxxxxxxxx xxxxxxxxxx	xxxxxxxxxx
xylem and phloem	are in of cells
xylem and the	phloem
xylene and mount	in
xylol and mount	in
