Z Arriving and	Departing
Z Compendium on	the
Z J Obstet	Gynaecol
Z Lebensm Unters	Forsch
Z Z Z	Z
Z Zellforsch Mikrosk	Anat
Z as a	function
Z axis of	the
Z can not	be
Z coordinates of	the
Z in terms	of
Z is a	vector function
Z is called	the
Z is equal	to
Z is given	by
Z is greater	than
Z is less	than
Z is the	atomic number impedance charge total set
Z is to	be
Z to undo	the
Z with respect	to
ZEBRA BOOKS KENSINGTON	PUBLISHING
ZEBRA BOOKS are	published
Zach shook his	head
Zachariah Chandler of	Michigan
Zadok the priest	and
Zakopane School of	Physics
Zambesi and its	Tributaries
Zambia African National	Congress
Zambia Congress of	Trade
Zambia Consolidated Copper	Mines
Zambia and South	Africa
Zamindari Abolition and	Land
Zanzibar and the	East
Zapata Lujan Ponce	de
Zapata and the	Mexican
Zapatista Army of	National
Zapatista National Liberation	Army
Zapatista de Liberacion	Nacional
Zapotec and Mixtec	Civilizations
Zborowski and Elizabeth	Herzog
Zeal of Thy	House
Zealand Association for	the
Zealand Banking Group	Ltd
Zealand Bill of	Rights
Zealand Closer Economic	Relations
Zealand College of	Psychiatrists
Zealand Council for	Educational
Zealand Court of	Appeal
Zealand Department of	Scientific Education
Zealand Environment and	Conservation
Zealand Federation of	Labour
Zealand First published	in
Zealand Historic Places	Trust
Zealand House of	Representatives
Zealand Institute of	International Economic
Zealand Journal of	Psychiatry Sociology Criminology History Science Educational Geology Agricultural Public Marine Botany Obstetrics Medicine Forestry Family Surgery Zoology Archaeology Developmental Industrial Ecology
Zealand Loan and	Mercantile
Zealand Ministry of	Education Foreign
Zealand Official Year	Book
Zealand Penguin Books	Ltd
Zealand Random House	South
Zealand Society of	Accountants
Zealand Te Papa	Tongarewa
Zealand and Australia	are and in have
Zealand and New	Caledonia South
Zealand and South	Africa America African
Zealand and in	the
Zealand and other	countries
Zealand and the	United Pacific South USA UK
Zealand as a	whole
Zealand as well	as
Zealand at the	time present end
Zealand in Parliament	assembled
Zealand in the	early south Second
Zealand is one	of
Zealand was the	first
Zebra and the	Z
Zebras Do not	Get
Zechariah the son	of
Zed and Two	Noughts
Zedekiah king of	Judah
Zedillo Ponce de	Leon
Zedong and Zhou	Enlai
Zeeb Road Ann	Arbor
Zeeman splitting of	the
Zeit der Weimarer	Republik
Zeitalter seiner technischen	Reproduzierbarkeit
Zeitschrift der Deutschen	Morgenlandischen Morgenldndischen
Zeitschrift der Gesellschaft	fur
Zeitschrift der deutschen	morgenlandischen
Zeitschrift des Deutschen	Palastina
Zeitschrift des Vereins	fur
Zeitschrift fiir Soziologie	und
Zeitschrift fiir Theologie	und
Zeitschrift fiir die	gesamte alttestamentliche
Zeitschrift fur Anglistik	und
Zeitschrift fur Geschichte	und
Zeitschrift fur Mathematik	und
Zeitschrift fur Morphologie	und
Zeitschrift fur Papyrologie	und
Zeitschrift fur Philosophic	und
Zeitschrift fur Philosophie	und
Zeitschrift fur Psychologie	und
Zeitschrift fur Romanische	Philologie
Zeitschrift fur Soziologie	und
Zeitschrift fur Theologie	und
Zeitschrift fur Volkswirtschaft	und
Zeitschrift fur Zellforschung	und
Zeitschrift fur angewandte	Psychologie
Zeitschrift fur auslandisches	offentliches
Zeitschrift fur betriebswirtschaftliche	Forschung
Zeitschrift fur bildende	Kunst
Zeitschrift fur celtische	Philologie
Zeitschrift fur das	gesamte
Zeitschrift fur deutsche	Philologie
Zeitschrift fur deutsches	Altertum
Zeitschrift fur die	gesamte alttestamentliche neutestamentliche Kunde Geschichte Alttestamentliche Gesamte Neutestamentliche gesammte
Zeitschrift fur katholische	Theologie
Zeitschrift fur philosophische	Forschung
Zeitschrift fur physikalische	Chemie
Zeitschrift fur physiologische	Chemie
Zeitschrift fur romanische	Philologie
Zeitschrift fur systematische	Theologie
Zeitschrift fur vergleichende	Sprachforschung
Zeitung fur die	elegante
Zen Buddhism and	Psychoanalysis
Zen Center of	Los
Zen Institute of	America
Zen and Japanese	Culture
Zen and the	Art art Birds
Zen in the	Art
Zen sect of	Buddhism
Zeroing in on	the
Zerubbabel the son	of
Zeta Phi Beta	Sorority
Zeus and all	the
Zeus and the	other
Zeus in the	form
Zeus of the	Greeks
Zhang Chunqiao and	Yao
Zhonggong zhongyang dangxiao	chubanshe
Zhongguo Shehui Kexue	Chubanshe
Zhongguo shehui kexue	chubanshe
Zhou Enlai and	the Deng
Zilla Parishads and	Panchayat
Zimbabwe African National	Union Liberation
Zimbabwe African Peoples	Union
Zimbabwe Congress of	Trade
Zimbabwe International Book	Fair
Zimbabwe and South	Africa
Zimbalist Rosaldo and	Louise
Zimring and Gordon	Hawkins
Zinc is an	essential
Zinoviev and Kamenev	were had
Zion Baptist Church	in
Zion Hospital and	Medical
Zion and in	Jerusalem
Zion and to	the
Zion for a	foundation
Zion more than	all
Zion of the	Holy
Zion shall be	redeemed
Zion shall go	forth
Zion with songs	and
Zionism and the	State Jewish Arabs
Zionism as a	form
Zionism to Our	Time
Zionist Archives and	Library
Zionist Congress in	Basel Basle
Zionist Movement and	the
Zionist Organization and	the
Zionist Organization of	America
Zionist movement and	the
Zionist movement as	a
Zionist movement in	the
Zionist point of	view
Zionist settlement in	Palestine
Zip Code For	faster
Zip I have	enclosed
Zip Please allow	four
Zip Please send	me
Zirconium in the	Nuclear
Zn Ga Ge	As
Zoe shook her	head
Zondervan Pictorial Encyclopedia	of
Zone Management Act	of
Zone Tower of	Terror
Zone and in	the
Zone of Peace	and
Zone of Proximal	Development
Zone of Southwest	Japan
Zone of proximal	development
Zone of the	Interior
Zones A and	B
Zones I and	II
Zones II and	III
Zones of Upper	Savoy
Zoning Board of	Appeals Adjustment Review
Zoning Commission of	Town
Zoning Law and	Practice
Zoning and Land	Use
Zoning and Planning	Law
Zoo and Aquarium	Association
Zoo and Wild	Animal
Zoo in New	York
Zoological Gardens in	London
Zoological Institute of	the
Zoological Journal of	the
Zoological Museum of	the
Zoological Park in	Washington
Zoological Parks and	Aquariums
Zoological Society of	London Japan San New Philadelphia
Zoological Survey of	India
Zoological and Botanical	Gardens
Zoologisches Institut der	Universitat
Zoology and Comparative	Anatomy
Zoology at Harvard	College University
Zoology at the	University
Zoology in the	University
Zoology of the	Voyage University
Zoom In and	Zoom
Zoom in on	the
Zoom in to	the
Zora Neale Hurston	and was Reader
Zorrilla de San	Martin
Zugleich ein Beitrag	zur
Zulfikar Ali Bhutto	and
Zulu of South	Africa
Zulus in South	Africa
Zur Frage nach	der dem
Zur Genealogie der	Moral
Zur Geschichte der	deutschen Juden Religion
Zur Kritik der	politischen Hegelschen Politischen
Zur Lehre von	der den
Zur Logik der	Sozialwissenschaften
Zur Sache des	Denkens
Zurich and London	Agreements
Zurich and New	York
Zwischen Himmel und	Erde
z are the	coordinates
z as a	function
z axis and	the
z axis in	the
z axis is	the
z axis of	the
z component of	the
z components of	the
z coordinate of	the
z coordinates of	the
z in terms	of
z is a	function
z is equal	to
z is given	by
z is greater	than
z is in	the
z is less	than
z is the	distance number vertical depth height charge coordinate valence
z o o	o
z o z	o
z transform of	the
z value corresponding	to
z with respect	to
z z z	z
za t i	on
zeal I served	my
zeal according to	knowledge
zeal and ability	of with in
zeal and activity	of in
zeal and affection	for to of
zeal and attachment	to
zeal and courage	of
zeal and devotion	to of in
zeal and diligence	in of
zeal and energy	of in which to
zeal and enthusiasm	of for
zeal and fidelity	of
zeal and industry	of in
zeal and interest	in
zeal and liberality	of
zeal and love	for of
zeal and piety	of
zeal and public	spirit
zeal and spirit	of
zeal and success	in
zeal as well	as
zeal displayed by	the
zeal for God	and
zeal for different	opinions
zeal for good	works
zeal for his	service country glory own religion Majesty
zeal for learning	and
zeal for liberty	and
zeal for public	good
zeal for religion	and
zeal for social	reform
zeal for the	public cause honour glory service interests salvation welfare faith Church good truth Lord conversion propagation law church honor Protestant common Catholic advancement promotion new spread rights interest true Law purity house Christian preservation King king improvement work spiritual divine success maintenance liberty religion reformation prosperity royal defence protestant general extension Roman
zeal for their	country religion own
zeal for truth	and
zeal for what	he
zeal for your	service
zeal in behalf	of
zeal in carrying	out
zeal in defence	of
zeal in favor	of
zeal in favour	of
zeal in his	service
zeal in promoting	the
zeal in support	of
zeal in the	cause service pursuit discharge work matter public performance
zeal in this	matter
zeal led him	to
zeal of a	new convert missionary few true
zeal of an	apostle
zeal of his	followers friends
zeal of some	of
zeal of the	people Lord early Christians missionaries new young clergy Christian reformers first Church French convert faithful Catholic English Roman missionary
zeal of thine	house
zeal of those	who
zeal on behalf	of
zeal on the	part
zeal to defend	the
zeal to do	good
zeal to make	the
zeal to promote	the
zeal to protect	the
zeal to serve	the
zeal to spread	the
zeal to the	cause study
zeal which he	had
zeal with which	he the they it you I she we this
zeal worthy of	a
zealous adherent of	the
zealous adherents of	the
zealous advocate for	the
zealous advocate of	the
zealous advocates for	the
zealous advocates of	the
zealous and active	in
zealous attachment to	the
zealous champion of	the
zealous champions of	the
zealous defender of	the
zealous defenders of	the
zealous devotion to	the
zealous efforts of	the
zealous for the	law honour Lord Law cause honor traditions good Church faith glory interests truth welfare
zealous friend of	the
zealous friend to	the
zealous friends of	the
zealous in his	efforts cause
zealous in promoting	the
zealous in the	cause service discharge performance pursuit work
zealous in their	efforts
zealous member of	the
zealous members of	the
zealous of good	works
zealous of the	law
zealous opponent of	the
zealous partisan of	the
zealous partisans of	the
zealous promoter of	the
zealous promoters of	the
zealous servant of	the
zealous support of	the
zealous supporter of	the
zealous supporters of	the
zealously attached to	the
zealously devoted to	the
zealously engaged in	the
zealously within the	bounds
zenith and the	nadir
zenith angle of	the
zenith distance of	the a
zenith distances of	the
zenith in the	early late
zenith of her	power glory fame
zenith of his	power fame career glory powers popularity reputation
zenith of its	power glory prosperity popularity fame
zenith of power	and
zenith of the	place observer
zenith of their	power glory
zenith to the	horizon
zero according to	the
zero and a	standard variance maximum
zero and all	the
zero and can	be
zero and constant	variance
zero and covariance	matrix
zero and first	order
zero and hence	the
zero and it	is
zero and less	than
zero and one	and
zero and solve	for
zero and solving	for the
zero and standard	deviation
zero and that	the
zero and the	other maximum second value first current total sum standard
zero and there	is
zero and therefore	the
zero and variance	one
zero and we	have
zero angle of	attack
zero as a	limit result
zero as in	the
zero as long	as
zero as shown	in
zero as soon	as
zero as the	number temperature
zero as well	as
zero at a	point distance
zero at absolute	zero
zero at all	times points
zero at any	point
zero at every	point
zero at some	point
zero at that	point
zero at the	end beginning center origin surface same point top wall bottom critical time start ends boundary equator centre absolute poles neutral instant edge outer left walls free edges
zero at this	point
zero basis in	the
zero because it	is
zero because of	the
zero because there	is
zero but less	than
zero by means	of
zero by the	end
zero can not	be
zero correlation between	the
zero corresponds to	the
zero crossing of	the
zero crossings of	the
zero degrees of	freedom
zero due to	the
zero elements in	the
zero elements of	the
zero end of	the
zero entries in	the
zero everywhere except	at
zero except for	the
zero flag is	set
zero for all	values other the
zero for each	of
zero for the	first
zero if and	only
zero if it	is
zero if there	is
zero in front	of
zero in on	the a what your one specific
zero in order	to
zero in such	a
zero in the	case limit first absence long second population middle region direction
zero in this	case
zero indicates that	the
zero interest rate	policy
zero is called	the a
zero is equal	to
zero is equivalent	to
zero is given	by
zero is not	a
zero level of	the
zero line of	the
zero line on	the
zero mark of	the
zero mark on	the
zero mean and	unit variance a constant standard covariance
zero means that	the
zero net present	value
zero of energy	is
zero of potential	energy
zero of temperature	is
zero of the	scale vernier function instrument
zero on the	scale right number boundary
zero only if	the
zero only in	the
zero only when	the
zero or a	one positive negative
zero or close	to
zero or even	negative
zero or greater	than
zero or less	than
zero or more	characters times occurrences of
zero or near	zero
zero or nearly	zero
zero or very	low small
zero orbital angular	momentum
zero order with	respect
zero point and	the
zero point at	the
zero point energy	of
zero point for	the
zero point in	the
zero point of	the charge
zero point on	the
zero point to	the
zero points of	the
zero position of	the
zero probability of	being
zero rate of	interest
zero reading of	the
zero reading on	the
zero regardless of	the
zero so that	the
zero the coefficients	of
zero there is	no
zero to a	maximum value positive
zero to its	maximum
zero to more	than
zero to one	hundred
zero to sixty	in
zero to some	maximum
zero to the	maximum right left value
zero up to	the a
zero value at	the
zero value for	the
zero value in	the
zero value of	the
zero values for	the
zero values in	the
zero values of	the
zero velocity at	the
zero when it	is
zero when the	two
zero when there	is
zero when they	are
zero with respect	to
zero zero zero	zero
zeroed in on	the a her his him
zeroes in on	the
zeroing in on	the a
zeros after the	decimal
zeros and poles	of
zeros at the	end
zeros in on	the
zeros in the	right
zeros of a	polynomial
zeros of the	function transfer polynomial denominator
zeros to the	right left
zeroth law of	thermodynamics
zest and juice	of
zest for life	and that
zest for living	and
zest with which	he the
zeta potential of	the
zigzag back and	forth
zigzagged back and	forth
zigzagging back and	forth
zinc and cadmium	in
zinc and copper	plates in are
zinc and dilute	sulphuric
zinc and hydrochloric	acid
zinc and lead	ores in are
zinc and other	metals
zinc and sulphuric	acid
zinc and the	copper
zinc as well	as
zinc concentration in	the
zinc content of	the
zinc deficiency in	the
zinc deposits of	the
zinc finger transcription	factor
zinc goes into	solution
zinc in a	solution
zinc in dilute	sulphuric
zinc in hydrochloric	acid
zinc in the	form diet
zinc ions in	the
zinc is added	to
zinc is dissolved	in
zinc is immersed	in
zinc is placed	in
zinc oxide and	eugenol
zinc oxide in	the
zinc plate of	the
zinc to the	copper
zip code in	the
zip code of	the
zip or postal	code
zipped up his	jacket pants
zipper of her	dress
zodiacal sign of	the
zona fasciculata and	zona
zona fasciculata of	the
zona glomerulosa of	the
zona pellucida of	the
zone above the	water
zone according to	the
zone adjacent to	the
zone ahead of	the
zone and at	the
zone and continental	shelf
zone and in	the
zone and into	the
zone and of	the
zone and on	the
zone and that	the
zone and the	continental other
zone and to	the
zone appears to	be
zone around the	British
zone as a	whole result function
zone as shown	in
zone as well	as
zone associated with	the
zone at a	depth
zone at the	base top crack end bottom time
zone because of	the
zone between the	two
zone between these	two
zone by means	of
zone can be	seen
zone can not	be
zone close to	the
zone coincides with	the
zone consists of	a the
zone corresponding to	the
zone corresponds to	the
zone depends on	the
zone due to	the
zone east of	the
zone extending from	the
zone extends from	the
zone from which	the
zone has its	own
zone has not	been
zone i to	zone
zone in Central	Europe
zone in South	Asia
zone in accordance	with
zone in front	of
zone in order	to
zone in relation	to
zone in terms	of
zone in the	south north region middle upper Middle area world vicinity center northern South lower southern form central western North
zone in which	the they it a there
zone is an	area
zone is assumed	to
zone is called	the
zone is characterised	by
zone is characterized	by
zone is composed	of
zone is defined	as by
zone is determined	by
zone is divided	into
zone is dominated	by
zone is due	to
zone is equal	to
zone is given	by
zone is in	the
zone is known	as
zone is less	than
zone is likely	to
zone is located	in
zone is made	up
zone is marked	by
zone is not	a
zone is occupied	by
zone is one	of
zone is represented	by
zone is shown	in
zone is that	of
zone is the	area most region
zone is to	be
zone known as	the
zone lying between	the
zone near the	surface
zone next to	the
zone north of	the
zone occupied by	the
zone of Germany	and
zone of North	America
zone of Sri	Lanka
zone of West	Africa
zone of action	of
zone of attached	gingiva
zone of contact	between of
zone of high	pressure
zone of influence	of in
zone of interests	protected to
zone of military	operations
zone of monetary	stability
zone of occupation	in and
zone of operations	of
zone of peace	and in
zone of polarizing	activity
zone of privacy	created which
zone of provisional	calcification
zone of proximal	development
zone of saturation	is
zone of the	earth city furnace northern country interior cortex southern adrenal North soil ocean sea Rhineland lens world body median Pacific medulla United high flame north USSR prostate upper central south South same Black lake eastern Northern lower spinal root cell western
zone of transition	between from
zone on both	sides
zone on either	side
zone on the	other right basis
zone or belt	of
zone or in	the
zone or on	the
zone parallel to	the
zone rather than	a
zone referred to	in
zone relative to	the
zone seems to	be
zone so as	to
zone so that	the
zone south of	the
zone than in	the
zone there is	a
zone to the	north south other east next west
zone to which	the
zone was to	be
zone west of	the
zone where it	is
zone where there	is
zone which has	been
zone with respect	to
zone within which	the
zoned for commercial	use
zoned for industrial	use
zoned for residential	use
zones A and	B
zones I and	II
zones II and	III
zones according to	the
zones adjacent to	the
zones and in	the
zones are based	on
zones are characterized	by
zones are separated	by
zones are shown	in
zones are to	be
zones around the	world
zones as well	as
zones based on	the
zones can be	distinguished identified
zones can not	be
zones close to	the
zones corresponding to	the
zones have been	established
zones in order	to
zones in relation	to
zones in terms	of
zones in the	United world country region north area
zones in which	the they
zones into which	the
zones may be	distinguished
zones of Germany	and
zones of North	America
zones of West	Africa
zones of influence	in of and
zones of occupation	in and
zones of proximal	development
zones of the	world earth country body city cortex United northern two Earth lens adrenal same lung brain region ocean
zones of weakness	in
zones on either	side
zones on the	basis
zones parallel to	the
zones such as	the
zones than in	the
zones that can	be
zones that have	been
zoning and building	codes
zoning and land	use
zoning and other	land
zoning and subdivision	regulations
zoning board of	appeals adjustment
zoning ordinance of	the
zoo in the	world
zoological and botanical	gardens
zoological point of	view
zoology and comparative	anatomy
zoology at the	University
zoology from the	University
zoom in and	out
zoom in for	a
zoom in on	the a an
zoom in or	out
zoom in to	the a
zoomed in for	a
zoomed in on	the a
zoomed out of	the
zooming in and	out
zooming in on	the a
zooming in or	out
zooms in on	the a
zooplankton biomass in	the
zoos around the	world
zu Frankfurt am	Main
zu Leben und	Werk
zu einem gewissen	Grade Grad
zu einer Geschichte	der
zu einer Kategorie	der
zu einer Kritik	der
zu einer Philosophie	der
zu einer Theorie	der des
zu einer allgemeinen	Geschichte
zu einer reinen	Phanomenologie
zugleich ein Beitrag	zur
zum Alten und	Neuen
zum Ausdruck zu	bringen
zum Ausgang des	Mittelalters
zum Neuen Testament	aus und
zum ersten Mal	in
zur Abwehr des	Antisemitismus
zur Allgemeinen und	Vergleichenden
zur Begutachtung der	gesamtwirtschaftlichen
zur Biologie der	Pflanzen
zur Einfuhrung in	die
zur Forderung der	wissenschaftlichen Wissenschaften
zur Frage nach	der
zur Geistesgeschichte des	Mittelalters
zur Geschichte der	deutschen Philosophie Juden altchristlichen Mathematik Philosophic Medizin Stadt Deutschen Arbeiterbewegung Naturwissenschaften
zur Geschichte des	deutschen Mittelalters Volkes antiken
zur Geschichte und	Kultur
zur Lehre von	der den
zur Metaphysik der	Sitten
zur Philosophic der	Geschichte
zur Philosophie der	Geschichte
zur Religion und	Literatur
zur Statistik des	Deutschen
zur Theologie des	Alten
zur Theorie und	Praxis
zur Wissenschaft vom	Alten
zur Wochenzeitung Das	Parlament
zur Zeitschrift fur	die
zur brandenburgischen und	preussischen
zur deutschen Literatur	des
zwischen Ost und	West
zwischen Reform und	Revolution
zwischen den beiden	Weltkriegen
zwischen der Bundesrepublik	Deutschland
zygomatic arch and	the
zygomatic arch to	the
zygomatic process of	the
zygomatic processes of	the
zygote develops into	a
zzril delenit augue	duis
