Z Compendium on the	European
Z Z Z Z	Z
Z as a function	of
Z is a vector	of
Z is the atomic	number
Z is the number	of
ZEBRA BOOKS are published	by
Zambia Congress of Trade	Unions
Zamindari Abolition and Land	Reforms
Zapata Lujan Ponce de	Leon
Zapata and the Mexican	Revolution
Zapatista Army of National	Liberation
Zealand Association for the	Advancement
Zealand Bill of Rights	Act
Zealand Closer Economic Relations	Trade
Zealand Council for Educational	Research
Zealand Department of Scientific	and
Zealand Institute of Economic	Research
Zealand Institute of International	Affairs
Zealand Journal of Agricultural	Research
Zealand Journal of Developmental	Disabilities
Zealand Journal of Educational	Studies
Zealand Journal of Family	Therapy
Zealand Journal of Geology	and
Zealand Journal of Industrial	Relations
Zealand Journal of Marine	and
Zealand Journal of Obstetrics	and
Zealand Journal of Public	Health
Zealand Journal of Science	and
Zealand Ministry of Foreign	Affairs
Zealand Random House South	Africa
Zealand and New South	Wales
Zealand and the Pacific	Islands
Zealand and the South	Pacific
Zealand and the United	States Kingdom
Zealand at the end	of
Zealand in the Second	World
Zealand is one of	the
Zebra and the Z	logo
Zebras Do not Get	Ulcers
Zeitschrift der Deutschen Morgenlandischen	Gesellschaft
Zeitschrift der Deutschen Morgenldndischen	Gesellschaft
Zeitschrift der Gesellschaft fur	Erdkunde
Zeitschrift der deutschen morgenlandischen	Gesellschaft
Zeitschrift fiir Theologie und	Kirche
Zeitschrift fiir die alttestamentliche	Wissenschaft
Zeitschrift fur Anglistik und	Amerikanistik
Zeitschrift fur Mathematik und	Physik
Zeitschrift fur Papyrologie und	Epigraphik
Zeitschrift fur Psychologie und	Physiologie
Zeitschrift fur Soziologie und	Sozialpsychologie
Zeitschrift fur Theologie und	Kirche
Zeitschrift fur Volkswirtschaft und	Statistik
Zeitschrift fur auslandisches offentliches	Recht
Zeitschrift fur deutsches Altertum	und
Zeitschrift fur die Alttestamentliche	Wissenschaft
Zeitschrift fur die Geschichte	des
Zeitschrift fur die Kunde	des
Zeitschrift fur die Neutestamentliche	Wissenschaft
Zeitschrift fur die alttestamentliche	Wissenschaft
Zeitschrift fur die gesamte	Staatswissenschaft Neurologie
Zeitschrift fur die neutestamentliche	Wissenschaft
Zeitung fur die elegante	Welt
Zen Center of Los	Angeles
Zen and the Art	of
Zen and the Birds	of
Zen and the art	of
Zen in the Art	of
Zeus and the other	gods
Zeus in the form	of
Zilla Parishads and Panchayat	Samitis
Zimbabwe African National Liberation	Army
Zimbabwe Congress of Trade	Unions
Zimbalist Rosaldo and Louise	Lamphere
Zion Hospital and Medical	Center
Zion for a foundation	a
Zion more than all	the
Zion of the Holy	One
Zion shall go forth	the
Zion with songs and	everlasting
Zionism and the State	of
Zionism as a form	of
Zionist Organization and the	Jewish
Zip Code For faster	service
Zip Please allow four	to
Zip Please send me	the
Zirconium in the Nuclear	Industry
Zn Ga Ge As	Se
Zondervan Pictorial Encyclopedia of	the
Zones of Upper Savoy	and
Zoning Board of Appeals	of
Zoning Board of Review	of
Zoning Commission of Town	of
Zoning and Land Use	Controls
Zoo and Wild Animal	Medicine
Zoological Journal of the	Linnean
Zoological Museum of the	University
Zoological Society of New	South
Zoological Society of San	Diego
Zoology at the University	of
Zoology in the University	of
Zoology of the University	of
Zoology of the Voyage	of
Zoom In and Zoom	Out
Zur Geschichte der Religion	und
z as a function	of
z is a function	of
z is the distance	from
z is the number	of
z is the vertical	coordinate
z z z z	z
zeal and ability with	which
zeal and activity in	the
zeal and activity of	the
zeal and attachment to	the
zeal and devotion of	the
zeal and devotion to	the
zeal and energy of	the
zeal for different opinions	concerning
zeal for the Catholic	religion faith
zeal for the Protestant	religion
zeal for the advancement	of
zeal for the cause	of
zeal for the common	cause
zeal for the conversion	of
zeal for the glory	of
zeal for the good	of
zeal for the honor	of
zeal for the honour	of and
zeal for the house	of
zeal for the improvement	of
zeal for the interest	of
zeal for the interests	of
zeal for the maintenance	of
zeal for the preservation	of
zeal for the promotion	of
zeal for the propagation	of
zeal for the prosperity	of
zeal for the public	good service welfare
zeal for the purity	of
zeal for the rights	of
zeal for the salvation	of
zeal for the service	of
zeal for the spread	of
zeal for the success	of
zeal for the welfare	of
zeal in behalf of	the
zeal in defence of	the
zeal in the cause	of
zeal in the discharge	of
zeal in the performance	of
zeal in the pursuit	of
zeal in the service	of
zeal of a new	convert
zeal of some of	the
zeal of the Lord	of
zeal of thine house	hath
zeal on behalf of	the
zeal on the part	of
zeal to the study	of
zeal with which he	had has
zeal worthy of a	better
zealous for the honor	of
zealous for the honour	of
zealous for the interests	of
zealous for the traditions	of
zealous in the cause	of
zealous in the discharge	of
zealous in the performance	of
zealous in the pursuit	of
zealous in the service	of
zealous in their efforts	to
zealously within the bounds	of
zenith angle of the	sun
zenith distance of the	sun star
zenith of his fame	and
zenith of his power	and
zenith of its power	and
zero and a standard	deviation
zero and a variance	of
zero and solving for	the
zero and there is	no
zero as a result	of
zero as the number	of
zero at the absolute	zero
zero at the beginning	of
zero at the center	of
zero at the end	of
zero at the neutral	axis
zero at the point	of
zero at the same	time
zero at the start	of
zero at the surface	of
zero at the time	of
zero at the top	of
zero because there is	no
zero by the end	of
zero for all values	of
zero if and only	if
zero if there is	no
zero in the absence	of
zero in the case	of
zero in the long	run
zero mean and a	variance
zero mean and constant	variance
zero mean and covariance	matrix
zero mean and standard	deviation
zero mean and unit	variance standard
zero on the number	line
zero or close to	zero
zero or more occurrences	of
zero order with respect	to
zero point of the	scale
zero point on the	scale
zero to a maximum	value of
zero to its maximum	value
zero to the left	of
zero to the right	of
zero when there is	no
zero with respect to	the
zeros after the decimal	point
zeros in the right	half
zeros of the transfer	function
zeros to the left	of
zeros to the right	of
zinc and dilute sulphuric	acid
zinc in dilute sulphuric	acid
zinc in the form	of
zip or postal code	along
zona fasciculata and zona	reticularis
zona glomerulosa of the	adrenal
zone ahead of the	crack
zone and the continental	shelf
zone around the British	Isles
zone as a function	of
zone as a result	of
zone as well as	the
zone at the base	of
zone at the crack	tip
zone at the end	of
zone at the top	of
zone in front of	the
zone in the Middle	East
zone in the middle	of
zone in the region	of
zone in the vicinity	of
zone in which it	is
zone is characterized by	the a
zone is determined by	the
zone is known as	the
zone is made up	of
zone is one of	the
zone of contact between	the
zone of influence of	the
zone of interests protected	by
zone of interests to	be
zone of occupation in	Germany
zone of peace in	the
zone of privacy created	by
zone of proximal development	is and
zone of the Black	Sea
zone of the United	States
zone of the adrenal	cortex
zone of the median	eminence
zone of the northern	hemisphere
zone of transition between	the
zone on both sides	of
zone on either side	of
zone or on the	continental
zones in the United	States
zones of occupation in	Germany
zones of the United	States
zones of the adrenal	cortex
zones on the basis	of
zoology at the University	of
zoology from the University	of
zoom in and out	of on
zu einer allgemeinen Geschichte	in
zu einer reinen Phanomenologie	und
zum Alten und Neuen	Testament
zum Neuen Testament aus	Talmud
zur Begutachtung der gesamtwirtschaftlichen	Entwicklung
zur Forderung der wissenschaftlichen	Forschung
zur Geschichte der Juden	in
zur Geschichte der Philosophie	des und
zur Geschichte der altchristlichen	Literatur
zur Geschichte der deutschen	Sprache Arbeiterbewegung
zur Geschichte des Volkes	Israel
zur Geschichte des antiken	Judentums
zur Geschichte und Kultur	des
zur Lehre von der	Gestalt
zur Philosophic der Geschichte	der
zur Philosophie der Geschichte	der
zur Religion und Literatur	des
zur Theologie des Alten	und
zur Wissenschaft vom Alten	und
zur Zeitschrift fur die	alttestamentliche
zur brandenburgischen und preussischen	Geschichte
zwischen der Bundesrepublik Deutschland	und
zygomatic process of the	temporal frontal maxilla squamosal
zzril delenit augue duis	dolore
