Q Please send a	free
Q Q Q Q	Q
Q R S T	U
Q as a function	of
Q if and only	if
Q is a function	of
Q is equal to	the
Q is given by	the
Q is proportional to	the
Q is the activation	energy
Q is the amount	of
Q is the charge	on
Q is the flow	rate
Q is the number	of
Q is the quality	factor
Q is the quantity	of
Q is the rate	of
Q is the set	of
Q is the volume	of flow
Q is the volumetric	flow
Q with respect to	the
QUANTITY DISCOUNTS WHEN USED	TO
QUESTIONS AND PROBLEMS FOR	DISCUSSION
QUESTIONS AND TOPICS FOR	DISCUSSION
QUESTIONS Answer the following	questions
QUESTIONS FOR DISCUSSION AND	REVIEW
QUESTIONS FOR REFLECTION AND	DISCUSSION
QUESTIONS FOR REVIEW AND	DISCUSSION
QUESTIONS FOR STUDY AND	DISCUSSION
QUESTIONS FOR THOUGHT AND	DISCUSSION
QUOTE BRIEF PASSAGES IN	A
Qatar and the United	Arab
Quaker Merchants of Colonial	Philadelphia
Quakers and Slavery in	America
Quakers in the American	Colonies
Qualification to any Office	or
Qualifications of its own	Members
Qualifications requisite for Electors	of
Qualified Dividends and Capital	Gain
Qualified Joint and Survivor	Annuity
Qualified requesters may obtain	copies
Qualitative Analysis for Social	Scientists
Qualitative Analysis with the	Blowpipe
Qualitative Characteristics of Accounting	Information
Qualitative Evaluation and Research	Methods
Qualitative analysis for social	scientists
Qualitative and Quantitative Methods	in
Qualitative evaluation and research	methods
Quality Assurance Agency for	Higher
Quality Assurance and Quality	Control
Quality Control and Applied	Statistics
Quality Control and Industrial	Statistics
Quality Management and Quality	Assurance
Quality Standards Subcommittee of	the
Quality Uncertainty and the	Market
Quality and Emissions Trends	Report
Quality and Reliability Engineering	International
Quality in a Growing	Economy
Quality in the Health	Care
Quality of Health Care	in
Quality of Life in	the America
Quality of life in	patients
Quality of life is	a
Quantitative Analysis for Business	Decisions
Quantitative Applications in the	Social
Quantitative Aspects of the	Economic
Quantitative Assaying with the	Blowpipe
Quantitative Chemical Analysis by	Electrolysis
Quantitative Ecological Analysis in	the
Quantitative monitoring of gene	expression
Quantity Value Quantity Value	Quantity
Quantity of Money and	Other
Quantum Mechanics and Path	Integrals
Quantum Theory of Atomic	Structure
Quantum Theory of Molecules	and
Quarrel of the Ancients	and
Quarrels That Have Shaped	the
Quarter Century of American	Politics
Quarter Second Quarter Third	Quarter
Quarter Sessions of the	Peace
Quarter Third Quarter Fourth	Quarter
Quarter of the Nineteenth	Century
Quarter of the Old	City
Quarterly Bulletin of the	South
Quarterly Courts of Essex	County
Quarterly Econometric Model of	the
Quarterly Financial Report for	Manufacturing
Quarterly Historical and Genealogical	Magazine
Quarterly Journal of Economics	for
Quarterly Journal of Engineering	Geology
Quarterly Journal of Experimental	Psychology Physiology
Quarterly Journal of International	Agriculture
Quarterly Journal of Medical	Science
Quarterly Journal of Microscopical	Science
Quarterly Journal of Military	History
Quarterly Journal of Speech	Education
Quarterly Journal of Studies	on
Quarterly Journal of the	Geological Royal Library Mythic
Quarterly Newsletter of the	Laboratory
Quarterly Progress and Status	Report
Quarterly Publications of the	American
Quarterly Review of Economics	and
Quarterly Review of Film	Studies and
Quarterly Review of Higher	Education
Quarterly Review of Historical	Studies
Quarterly for Exercise and	Sport
Quarterly of Behavior and	Development
Quarterly of Community Health	Education
Quarterly of Culture and	Society
Quarterly of the American	Physical Association
Quarterly of the Department	of
Quarterly of the Oregon	Historical
Quarterly of the Texas	State
Quartermaster Food and Container	Institute
Quartermaster General of the	Army
Quartet for the End	of
Quaternary Environments of the	United
Quaternary of the United	States
Quatuor pour la fin	du
Quebec and the Maritime	Provinces
Quebec and the rest	of
Quebec as a distinct	society
Queen City of the	West Plains South
Queen Elizabeth I of	England
Queen Elizabeth II Arts	Council
Queen Elizabeth II and	Prince the
Queen Elizabeth II of	England
Queen Elizabeth The Queen	Mother
Queen Elizabeth and King	James
Queen Elizabeth and Prince	Philip
Queen Elizabeth came to	the
Queen Elizabeth the Queen	Mother
Queen Isabella and King	Ferdinand
Queen Jane and Queen	Mary
Queen Juliana of the	Netherlands
Queen Mary and Queen	Elizabeth
Queen Mary and Westfield	College
Queen Mother of the	West
Queen Victoria Museum and	Art
Queen Victoria Road New	Delhi
Queen Victoria and Prince	Albert
Queen Victoria and the	Prince
Queen Victoria ascended the	throne
Queen Victoria came to	the
Queen Victoria of Great	Britain
Queen Victoria was proclaimed	Empress
Queen Wilhelmina of the	Netherlands
Queen and Prince of	Wales
Queen and other members	of
Queen and the Duke	of
Queen and the Prince	Consort of
Queen and the Royal	Family
Queen came to the	throne
Queen gave birth to	a
Queen has been pleased	to
Queen in Right of	Canada
Queen is said to	have
Queen of Air and	Darkness
Queen of America Goes	to
Queen of England and	the her
Queen of Great Britain	and
Queen of Heaven and	Earth
Queen of Hungary and	Bohemia
Queen of Love and	Beauty
Queen of Scots and	the her
Queen of Scots had	been
Queen of Scots on	the
Queen of Scots to	the
Queen of Sheba to	Solomon
Queen of the Night	in
Queen of the United	Kingdom
Queen of the West	and
Queen on the advice	of
Queens College in New	York
Queens College of the	City
Queens have died young	and
Queensland Department of Primary	Industries
Queensland Institute of Medical	Research
Queensland and New South	Wales
Queensland and northern New	South
Queensland and the Northern	Territory
Queer Eye for the	Straight
Queer Politics and Social	Theory
Quellen und Forschungen aus	italienischen
Quellen und Forschungen zur	Geschichte Sprach
Quellen und Studien zur	Geschichte
Quellen und Untersuchungen zur	Geschichte
Querelle des Anciens et	des
Querelle des anciens et	des
Queries for a Transnational	Anthropology
Queries regarding rights and	permissions
Query or send complete	ms
Query with outline and	sample
Query with published clips	or
Quest for Modernity in	Asia
Quest for Power and	Liberty
Quest for a New	World
Quest for the Historical	Jesus
Quest for the Holy	Grail
Quest of the Historical	Jesus
Quest of the Holy	Grail
Quest of the Silver	Fleece
Question Concerning Technology and	Other
Question and Reformism in	Latin
Question in Feminism and	the
Question in Greece and	Turkey
Question in the New	Europe
Question in the Soviet	Union
Question in the United	States
Question of Law or	Fact
Questioning Narratives of Modern	China
Questionnaire Design and Attitude	Measurement
Questions Answer the following	questions
Questions The following Frequently	Asked
Questions about the nature	of
Questions and Answers about	the
Questions and Answers in	Attitude
Questions and Answers on	the Genesis
Questions and Topics for	Discussion
Questions at the end	of
Questions for Discussion and	Review Writing
Questions for Reflection and	Discussion
Questions for Review and	Discussion
Questions for Study and	Discussion Review
Questions for Thought and	Discussion
Questions for Writing and	Discussion
Questions have also been	raised
Questions have been raised	about as
Questions in the History	of
Questions of Ambivalence and	Authority
Questions of Interpretation and	Application
Questions of law or	fact
Questions of this kind	are
Questions of this sort	are
Questions such as the	following
Questions such as these	are can have
Questions that need to	be
Questions were asked about	the
Questions were asked in	the
Questions were raised about	the
Quick as a flash	he the
Quiescence and Rebellion in	an
Quiet Revolution in Land	Use
Quiet on the Western	Front
Quincy Adams and Andrew	Jackson
Quincy Adams and Henry	Clay
Quincy Adams and the	Foundations Union
Quintet for Piano and	Strings
Quintin Hoare and Geoffrey	Nowell
Quip for an Upstart	Courtier
Quirinius was governor of	Syria
Quit to return to	the
Quite a few of	the them these
Quite a few years	ago
Quite a good number	of
Quite a large number	of
Quite a large proportion	of
Quite a lot of	people the
Quite a number of	the people them these other our men
Quite apart from anything	else
Quite apart from the	fact question problem obvious
Quite as important as	the
Quite aside from the	fact
Quite in contrast to	the
Quite out of the	question
Quite the contrary is	true the
Quite the opposite is	true the
Quite the reverse is	true
Qumran and the New	Testament
Quorum of the Twelve	Apostles
Quotation marks are used	to
Quotations from Buddhist Literature	for
Quotations from Chairman Mao	Tse
Quotations in this paragraph	are
Quoted by permission of	the The
Quoted in New York	Times
Quoted in The New	York
Quoted in the New	York
Quoted with permission of	the
Quoted with the permission	of
q as a function	of
q if and only	if
q is the charge	on of
q is the density	of
q is the electron	charge
q is the electronic	charge
q is the heat	flux
q is the magnitude	of
q is the number	of
q is the probability	of
q is the rate	of
quadrant of the left	breast
quadrant of the right	breast
quadrant of the spinal	cord
quadratic equation of the	form
quadrupling of oil prices	in
quadrupling of the price	of
quailed at the thought	of
quaint and curious volume	of
qualification for admission to	the
qualification for any office	or
qualification for membership in	the
qualification for membership of	the
qualification for the exercise	of
qualification for the office	of
qualification in the case	of
qualification of a person	to
qualification reasonably necessary to	the
qualification to any office	or
qualifications and experience of	the
qualifications and maximum hours	of
qualifications and none of	the
qualifications and salaries of	teachers
qualifications as may be	prescribed
qualifications for admission to	the
qualifications for members of	the
qualifications for membership in	the
qualifications for membership of	the
qualifications for the office	of
qualifications for the position	of
qualifications necessary to become	a
qualifications need to be	made
qualifications of a candidate	for
qualifications of its own	members
qualifications of members of	the
qualifications of the members	of
qualifications of the person	who
qualifications on the part	of
qualifications required in their	respective
qualifications requisite for electors	of
qualifications set forth in	the
qualifications solely because of	their
qualified and liable to	serve
qualified as a doctor	in
qualified as a member	of
qualified as an expert	by in witness
qualified as one of	the
qualified by scientific training	and
qualified by the fact	that
qualified by the observation	that
qualified by the statement	that
qualified by training and	experience
qualified cash or deferred	arrangement
qualified class name of	the
qualified electors of the	city State state
qualified for admission to	the
qualified for appointment as	a
qualified for election as	a
qualified for membership in	the
qualified for such a	task
qualified for such an	undertaking
qualified for the discharge	of
qualified for the duties	of
qualified for the marital	deduction
qualified for the office	of
qualified for the position	of
qualified for the task	of
qualified for the work	of
qualified him to be	a
qualified in accordance with	the
qualified in its entirety	by
qualified in the field	of
qualified in the light	of
qualified individual with a	disability
qualified joint and survivor	annuity
qualified majority in the	Council
qualified majority on a	proposal
qualified majority voting in	the
qualified on the basis	of
qualified pension or profit	sharing
qualified publicists of the	various
qualified real property business	indebtedness
qualified separate line of	business
qualified separate lines of	business
qualified to act as	a an
qualified to be a	member
qualified to be appointed	as a
qualified to be chosen	to
qualified to be elected	as
qualified to be included	in
qualified to be registered	as
qualified to carry on	the
qualified to carry out	the
qualified to comment on	the
qualified to deal with	the
qualified to discharge the	duties
qualified to do business	in
qualified to do justice	to
qualified to do the	job work
qualified to express an	opinion
qualified to fill the	position
qualified to form a	judgment
qualified to form an	opinion
qualified to give an	opinion
qualified to judge of	the
qualified to participate in	the
qualified to pass judgment	on
qualified to perform the	duties
qualified to serve as	a jurors
qualified to serve on	juries
qualified to sit in	the
qualified to speak on	the this
qualified to speak with	authority
qualified to take care	of
qualified to take charge	of
qualified to take part	in
qualified to testify as	an to
qualified to the extent	that
qualified to vote at	the such
qualified to vote for	members the
qualified to vote in	the elections
qualified to vote under	the
qualified to write on	the
qualified to write this	book
qualified trust under this	section
qualified tuition and related	expenses
qualified under the provisions	of
qualified voters of said	city
qualified voters of such	State
qualified voters of the	city county State town district
qualifies as one of	the
qualifies for the marital	deduction
qualify as a bona	fide
qualify as a charitable	remainder
qualify as a holder	in
qualify as a member	of
qualify as a reorganization	under
qualify as a small	business
qualify as a trade	secret
qualify as alimony or	separate
qualify as an S	corporation
qualify as one of	the
qualify for Social Security	benefits
qualify for a diagnosis	of
qualify for admission to	the
qualify for an exemption	from
qualify for any of	the
qualify for capital gain	treatment
qualify for capital gains	treatment
qualify for free or	reduced
qualify for inclusion in	the
qualify for membership in	the
qualify for one of	the
qualify for protection under	the
qualify for special education	services
qualify for the annual	exclusion gift
qualify for the estate	tax
qualify for the gift	tax
qualify for the investment	credit
qualify for the marital	deduction
qualify for the title	of
qualify him to be	a
qualify on the basis	of
qualify themselves for their	performance
qualify to do business	in
qualifying for the marital	deduction
qualifying income interest for	life
qualifying them to hold	office
qualitative agreement with the	experimental
qualitative and quantitative analyses	of
qualitative and quantitative analysis	of
qualitative and quantitative approaches	to
qualitative and quantitative aspects	of
qualitative and quantitative assessment	of
qualitative and quantitative changes	in
qualitative and quantitative characteristics	of
qualitative and quantitative composition	of
qualitative and quantitative determination	of
qualitative and quantitative differences	in between
qualitative and quantitative evaluation	of
qualitative and quantitative information	about
qualitative and quantitative methods	in
qualitative and quantitative research	methods
qualitative and quantitative study	of
qualitative as well as	quantitative a
qualitative change in the	nature
qualitative characteristics of accounting	information
qualitative difference between the	two
qualitative differences between the	two
qualitative rather than a	quantitative
qualitatively and quantitatively different	from
qualitatively as well as	quantitatively
qualitatively different from that	of
qualitatively different from those	of
qualitatively in terms of	the
qualitatively similar to that	of
qualitatively similar to those	of
qualitatively the same as	that in the those
qualities and artistic possibilities	and
qualities and attributes of	the
qualities and characteristics of	the
qualities are not to	be
qualities are to be	found
qualities as a man	and
qualities as well as	the
qualities at the same	time
qualities for which he	was
qualities in a high	degree
qualities in a higher	degree
qualities in the character	of
qualities of a good	teacher
qualities of a high	order
qualities of a work	of
qualities of body and	mind
qualities of each of	the
qualities of head and	heart
qualities of heart and	mind head
qualities of his mind	and
qualities of mind and	heart character body spirit soul
qualities of some of	the
qualities of the head	and
qualities of the heart	and
qualities of the highest	order
qualities of the human	mind spirit
qualities of the mind	and are
qualities on the part	of
qualities similar to those	of
qualities that are essential	to
qualities that are to	be
qualities that can not	be
qualities that go to	make
qualities that made him	a
qualities that make a	good man
qualities that make for	success
qualities that make up	the
qualities to be found	in
qualities to look for	in
qualities which are common	to
qualities which are essential	to
qualities which are incapable	of
qualities which are necessary	to
qualities which belong to	the
qualities which can not	be
qualities which enabled him	to
qualities which endeared him	to
qualities which go to	make the
qualities which made him	a
qualities which make a	man
qualities which make up	the
qualities with which it	is
quality and accuracy of	the
quality and appearance of	the
quality and appropriateness of	the
quality and at the	same
quality and character of	the
quality and characteristics of	the
quality and completeness of	the
quality and composition of	the
quality and condition of	the
quality and consistency of	the
quality and content of	the
quality and cost of	the
quality and depth of	the
quality and effectiveness of	the
quality and efficiency of	the
quality and extent of	the
quality and form for	publication
quality and integrity of	the
quality and intensity of	the
quality and length of	life
quality and nature of	the
quality and performance of	the
quality and price of	the
quality and productivity of	the
quality and purity of	the
quality and quantity in	the
quality and quantity of	the work their food information his its life production output water services data goods available a education service our your these
quality and relevance of	the
quality and reliability of	the
quality and safety of	the
quality and scope of	the
quality and size of	the
quality and stability of	the
quality and strength of	the
quality and texture of	the
quality and the amount	of
quality and the cost	of
quality and the number	of
quality and the quantity	of
quality and timeliness of	the
quality and usefulness of	the
quality and value for	money
quality and value of	the
quality and variety of	the
quality as a function	of
quality as a result	of
quality as that of	the
quality as well as	the quantity in to a of
quality assurance and quality	control
quality at the end	of
quality at the expense	of
quality at the lowest	possible
quality at the same	time
quality at the time	of
quality black and white	photographic
quality books and multimedia	programs
quality can be improved	by
quality comparable to that	of
quality control and quality	assurance
quality control policies and	procedures
quality editions of the	complete
quality education for all	children
quality education for their	children
quality equal to that	of
quality from that of	the
quality in relation to	the
quality in terms of	the
quality in the United	States
quality in the case	of
quality in the context	of
quality in the face	of
quality in virtue of	which
quality is a function	of
quality is a matter	of
quality is determined by	the
quality is due to	the
quality is found in	the
quality is heavily dependent	upon
quality is likely to	be
quality is more important	than
quality is not as	good
quality is one of	the
quality is said to	be
quality is the result	of
quality is to be	found
quality of a piece	of
quality of a product	or is
quality of a work	of
quality of air and	water
quality of an individual	personality
quality of attachment and	later
quality of being able	to
quality of care and	the quality
quality of care for	the
quality of care given	to
quality of care in	the nursing
quality of care provided	by to in
quality of care received	by
quality of each of	the
quality of education and	the training
quality of education at	all the
quality of education available	to
quality of education for	all
quality of education in	the
quality of education received	by
quality of exercise for	developing
quality of goods and	services
quality of goods or	services
quality of health care	in services and for
quality of his mind	and
quality of his or	her
quality of his work	and is was
quality of human life	and in
quality of information available	to
quality of instruction in	the
quality of its products	and
quality of life among	the
quality of life and	the to health a social well economic survival life that functional of
quality of life as	well a
quality of life associated	with
quality of life at	the
quality of life can	be not
quality of life due	to
quality of life during	the
quality of life enjoyed	by
quality of life experienced	by
quality of life for	the all people patients those many everyone individuals older a children their its residents both these our most persons women themselves millions
quality of life has	been
quality of life have	been
quality of life in	the a patients their our rural this America general urban these cancer terms an old older many children cities
quality of life is	a not the to
quality of life may	be
quality of life must	be
quality of life of	the patients people all its a those their older individuals our cancer these many children women persons
quality of life on	the
quality of life rather	than
quality of life should	be
quality of life that	is
quality of life through	the
quality of life to	be the
quality of life which	is
quality of life will	be
quality of life within	the
quality of life would	be
quality of many of	the these
quality of marriage and	similar
quality of materials and	workmanship
quality of medical care	in and is
quality of mercy is	not
quality of most of	the
quality of much of	the
quality of nursing home	care
quality of our lives	and
quality of patient care	and
quality of performance of	the
quality of product or	service
quality of products and	services
quality of products or	services
quality of service and	the
quality of service in	the
quality of service provided	by to
quality of service rendered	by
quality of service to	the
quality of services provided	by to
quality of some of	the these
quality of teaching and	learning research the
quality of teaching in	the
quality of the act	he the
quality of the air	in we and
quality of the available	data
quality of the built	environment
quality of the care	provided
quality of the content	of
quality of the copy	submitted
quality of the data	and is collected used obtained that available in
quality of the decision	is
quality of the decisions	made
quality of the design	and
quality of the drinking	water
quality of the education	provided they
quality of the educational	program experience
quality of the end	product
quality of the environment	and in is
quality of the experience	of
quality of the final	product
quality of the finished	product
quality of the food	and is served
quality of the goods	and or produced they sold
quality of the health	care
quality of the home	environment
quality of the housing	stock
quality of the human	environment mind
quality of the image	is
quality of the information	that provided available they and obtained
quality of the input	data
quality of the interaction	between
quality of the labor	force
quality of the labour	force
quality of the land	and
quality of the learning	experience
quality of the life	of
quality of the lives	of
quality of the marital	relationship
quality of the material	submitted and used is
quality of the materials	used and
quality of the medical	care
quality of the men	who
quality of the milk	is
quality of the mind	of
quality of the natural	environment
quality of the original	submitted
quality of the output	of
quality of the paper	and
quality of the people	who
quality of the performance	of
quality of the physical	environment
quality of the product	and is or was in to as
quality of the products	and of they
quality of the raw	material materials
quality of the relationship	between with that is and
quality of the relationships	between
quality of the reproduction	is
quality of the research	and
quality of the rest	of
quality of the results	obtained of
quality of the service	provided rendered and they is
quality of the services	provided they rendered offered
quality of the soil	and is in
quality of the sound	is
quality of the state	of
quality of the student	body
quality of the teaching	and staff
quality of the therapeutic	relationship
quality of the urban	environment
quality of the voice	is
quality of the water	in is and supply used
quality of the waters	of
quality of the work	done of and is performed that force produced they in was environment being he which itself
quality of the writing	and
quality of their lives	and
quality of their own	work lives
quality of their products	and
quality of their relationship	with
quality of their relationships	with
quality of their work	and is
quality of this kind	of
quality of this reprint	but
quality of this reproduction	is
quality of this type	of
quality of water in	the
quality of water intended	for
quality of work and	the
quality of work done	by in
quality of work in	the
quality of work life	and for in
quality of work performed	by
quality of working life	and in
quality of your life	and
quality on the basis	of
quality on the part	of
quality or character of	the
quality or condition of	the being
quality or nature of	the
quality or quantity of	the
quality or state of	being
quality or the quantity	of
quality or value of	the such
quality rather than quantity	of
quality rather than the	quantity
quality reproduction could be	made
quality similar to that	of
quality than that of	the
quality than those of	the
quality that assure a	good
quality that can not	be
quality to be found	in
quality to that of	the
quality to those of	the
quality to your moments	as
quality which can not	be
quandary as to how	to
quandary as to what	to
quantification of the amount	of
quantified in terms of	the
quantified on the basis	of
quantify the degree to	which
quantify the effect of	the
quantify the effects of	the
quantify the extent of	the
quantify the extent to	which
quantify the impact of	the
quantitation of microgram quantities	of
quantitative analysis of the	data
quantitative and qualitative analysis	of
quantitative and qualitative approaches	to
quantitative and qualitative aspects	of
quantitative and qualitative changes	in
quantitative and qualitative characteristics	of
quantitative and qualitative differences	in
quantitative and qualitative research	methods
quantitative as well as	qualitative
quantitative description of membrane	current
quantitative measure of the	degree amount
quantitative measures of dementia	and
quantitative rather than a	qualitative
quantitative restrictions on imports	and of
quantitatively and qualitatively different	from
quantitatively as well as	qualitatively
quantitatively in terms of	the
quantities are related by	the
quantities are related to	the
quantities are used in	the
quantities as a function	of
quantities can be expressed	in
quantities in terms of	the
quantities in the United	States
quantities in the form	of
quantities in the manufacture	of
quantities in which such	commodities
quantities in which they	are
quantities of all kinds	of
quantities of arms and	ammunition
quantities of butter and	cheese
quantities of capital and	labor
quantities of carbon dioxide	and
quantities of each of	the
quantities of food and	drink
quantities of fruits and	vegetables
quantities of gold and	silver
quantities of goods and	services
quantities of goods to	be
quantities of iron and	steel
quantities of labor and	capital
quantities of not less	than
quantities of oil and	gas
quantities of positive and	negative
quantities of protein utilizing	the
quantities of raw materials	and
quantities of sand and	gravel
quantities of silver and	gold
quantities of some of	the
quantities of the first	order
quantities of the order	of
quantities of the precious	metals
quantities of the same	kind order
quantities of the second	order
quantities of the two	goods
quantities of water are	used
quantities of water from	the
quantities of water in	the
quantities of water into	the
quantities on the right	side
quantities that can be	measured
quantities that can not	be
quantity and character of	the
quantity and composition of	the
quantity and distribution of	the
quantity and improve the	quality
quantity and intensity of	the
quantity and nature of	the
quantity and price of	the
quantity and quality in	the
quantity and quality of	the work their food information its water his output goods production services available education data labor life a exercise service resources our labour these milk children research light social land this public each
quantity and size of	the
quantity and the quality	of
quantity and the value	of
quantity and value of	the
quantity and variety of	the
quantity as a function	of
quantity as well as	quality the in
quantity at the expense	of
quantity but also in	quality
quantity but also the	quality
quantity but the quality	of
quantity demanded and quantity	supplied
quantity demanded and the	quantity
quantity demanded at each	price
quantity demanded divided by	the
quantity demanded equals quantity	supplied
quantity demanded equals the	quantity
quantity demanded exceeds quantity	supplied
quantity demanded exceeds the	quantity
quantity demanded is equal	to
quantity demanded is greater	than
quantity demanded is less	than
quantity demanded of a	good commodity
quantity demanded of one	good
quantity demanded of the	good
quantity demanded to a	change
quantity demanded to changes	in
quantity discounts for bulk	purchases
quantity discounts on bulk	purchases
quantity discounts to use	as
quantity discounts when purchased	in
quantity discounts with bulk	purchase
quantity for bulk purchases	or
quantity for corporate use	or
quantity for industrial or	sales
quantity in Column A	is
quantity in Column B	is
quantity in terms of	the
quantity is a function	of
quantity is a measure	of
quantity is defined as	the
quantity is determined by	the
quantity is equal to	the
quantity is known as	the
quantity is less than	the
quantity is proportional to	the
quantity is related to	the
quantity is said to	be
quantity of a good	that or demanded
quantity of a product	that
quantity of a solution	of
quantity of air in	the
quantity of air passing	through
quantity of air required	for
quantity of air to	be
quantity of air which	is
quantity of all sorts	of
quantity of any of	the
quantity of arms and	ammunition
quantity of barren spectators	to
quantity of blood contained	in
quantity of blood from	the
quantity of blood in	the
quantity of blood into	the
quantity of blood may	be
quantity of blood to	be
quantity of capital and	labour
quantity of carbon dioxide	in
quantity of carbonate of	lime soda
quantity of carbonic acid	gas in is exhaled
quantity of chloride of	sodium
quantity of dilute sulphuric	acid
quantity of each kind	of
quantity of each of	the these
quantity of each type	of
quantity of electricity in	the
quantity of electricity on	the
quantity of electricity passed	through
quantity of electricity passing	through
quantity of electricity required	to
quantity of electricity that	passes
quantity of electricity which	passes has is flows
quantity of energy in	the
quantity of fat in	the
quantity of fluid in	the
quantity of food and	drink clothing
quantity of food consumed	by
quantity of food in	the
quantity of food to	be
quantity of gas in	the
quantity of gold and	silver
quantity of gold in	the
quantity of gold or	silver
quantity of goods and	services
quantity of goods in	the
quantity of goods or	services
quantity of goods shown	in
quantity of goods to	be
quantity of heat absorbed	by
quantity of heat equal	to
quantity of heat from	the
quantity of heat given	out
quantity of heat in	the
quantity of heat must	be
quantity of heat necessary	to
quantity of heat needed	to
quantity of heat produced	by
quantity of heat required	to
quantity of heat that	is
quantity of heat to	be
quantity of heat which	is must would the
quantity of interest is	the
quantity of iron in	the
quantity of it in	the
quantity of labour and	capital subsistence
quantity of labour bestowed	on
quantity of labour employed	in
quantity of labour necessary	to
quantity of labour required	to for
quantity of labour which	it they is
quantity of land in	the
quantity of land to	be
quantity of liquid in	the
quantity of loanable funds	demanded
quantity of material in	the
quantity of material to	be
quantity of matter contained	in
quantity of matter in	the a
quantity of means of	production
quantity of moisture in	the
quantity of money and	the its
quantity of money demanded	is
quantity of money in	circulation the a existence
quantity of money will	be
quantity of motion in	the
quantity of nitrogen in	the
quantity of oil in	the
quantity of one of	the
quantity of organic matter	in
quantity of output at	which
quantity of oxide of	iron
quantity of oxygen contained	in
quantity of oxygen in	the
quantity of phosphate of	lime
quantity of powder and	shot
quantity of protein in	the
quantity of rain that	falls
quantity of rain which	falls
quantity of real GDP	demanded
quantity of salt in	the
quantity of silver in	the
quantity of sugar in	the
quantity of the circulating	medium
quantity of the electric	fluid
quantity of the latter	is
quantity of the matter	of
quantity of the means	of
quantity of the necessaries	and of
quantity of the order	of
quantity of the precious	metals metal
quantity of the produce	of
quantity of the products	of
quantity of the public	good
quantity of the same	kind
quantity of the second	order
quantity of uric acid	in
quantity of urine passed	in
quantity of water and	the
quantity of water at	the a
quantity of water available	for
quantity of water can	be
quantity of water contained	in
quantity of water equal	to
quantity of water flowing	through in
quantity of water for	the
quantity of water from	the
quantity of water in	the a
quantity of water into	the
quantity of water is	added
quantity of water may	be
quantity of water must	be
quantity of water necessary	to
quantity of water passing	through
quantity of water required	for to
quantity of water should	be
quantity of water that	is can
quantity of water to	be the
quantity of water used	in
quantity of water which	is the it can
quantity of water will	be
quantity of work done	by
quantity of work to	be
quantity or quality of	the production work
quantity or the quality	of
quantity or value of	the
quantity rather than quality	of
quantity rather than the	quality
quantity supplied and quantity	demanded
quantity supplied and the	quantity
quantity supplied divided by	the
quantity supplied equals the	quantity
quantity supplied exceeds the	quantity
quantity supplied is greater	than
quantity supplied of a	good
quantity that is to	be
quantity theory of money	and is in
quantity which can not	be
quantity within each unit	and
quantum efficiency of the	detector
quantum mechanical description of	the
quantum mechanical treatment of	the
quantum mechanics and general	relativity
quantum theory of atomic	structure
quantum theory of the	atom
quarrel between him and	the his
quarrel between husband and	wife
quarrel between philosophy and	poetry
quarrel between the King	and
quarrel between the ancients	and
quarrel between the king	and
quarrel between the two	men
quarrel broke out between	the
quarrel is not with	the
quarrel over the division	of
quarrel was not with	the
quarrel with one of	the his
quarrel with the Duke	of
quarrel with the German	people
quarrel with the United	States
quarrel with the people	of
quarrels and wars of	the
quarrels between husband and	wife
quart and a half	of
quart of milk a	day
quart saucepan over medium	heat
quarter and a half	of
quarter and a third	of
quarter and one third	of
quarter from which the	wind
quarter mile down the	road
quarter of a billion	dollars
quarter of a century	ago later of before after earlier has the in and since to had he or that was old is from it have as which I a by there with afterwards for at following on they now we this been between passed would elapsed back will without past
quarter of a cup	of
quarter of a grain	of
quarter of a league	from in of distant
quarter of a mile	from away of in to long wide distant off or below down south beyond above north before farther and ahead broad on up apart further west east across behind along out back when through into the at square inland without over we
quarter of a million	dollars people of pounds men in copies miles sterling tons years acres inhabitants to persons and a members square words Jews for more children workers troops or votes
quarter of a percentage	point
quarter of a pint	of
quarter of a pound	of
quarter of a square	mile
quarter of a teaspoonful	of
quarter of a ton	of
quarter of a wave	length
quarter of a yard	of
quarter of a year	after
quarter of an acre	of in
quarter of an hour	later before after to the in or of he at I and ago we afterwards with had they for passed she was from on a when it longer late without earlier more that together elapsed is by there since went each you too every afterward while all until during which
quarter of an inch	in thick long of from to wide or deep apart above below square and broad at across on high
quarter of an ounce	of
quarter of high school	class
quarter of one per	cent
quarter of one percent	of
quarter of that of	the
quarter of the Nineteenth	Century
quarter of the Old	City
quarter of the United	States
quarter of the XII	century
quarter of the adult	population
quarter of the amount	of
quarter of the area	of
quarter of the calendar	year
quarter of the century	the was and that in
quarter of the circumference	of
quarter of the city	was and where of in which is to
quarter of the cost	of
quarter of the current	year
quarter of the diameter	of
quarter of the eighteenth	century
quarter of the eighth	century
quarter of the eleventh	century
quarter of the entire	population
quarter of the fifteenth	century
quarter of the fifth	century
quarter of the financial	year
quarter of the first	century year
quarter of the fiscal	year
quarter of the fourteenth	century
quarter of the fourth	century
quarter of the globe	to and where
quarter of the human	race
quarter of the labor	force
quarter of the labour	force
quarter of the last	century
quarter of the length	of
quarter of the members	of
quarter of the national	income
quarter of the next	century
quarter of the nineteenth	century and
quarter of the ninth	century
quarter of the northeast	quarter
quarter of the northwest	quarter
quarter of the number	of
quarter of the past	century
quarter of the population	of is was in
quarter of the preceding	year
quarter of the present	century
quarter of the previous	year
quarter of the seats	in
quarter of the second	century millennium
quarter of the seventeenth	century
quarter of the seventh	century
quarter of the sixteenth	century
quarter of the sixth	century
quarter of the size	of
quarter of the southeast	quarter
quarter of the southwest	quarter
quarter of the tenth	century
quarter of the third	century
quarter of the thirteenth	century
quarter of the total	population number area
quarter of the town	where in was
quarter of the twelfth	century
quarter of the twentieth	century
quarter of the value	of
quarter of the votes	cast
quarter of the way	through around up down to from across
quarter of the weight	of
quarter of the whole	population
quarter of the work	force
quarter of the world	to
quarter of the year	and the
quarter of what it	was had
quarter or a third	of
quarter or half a	mile
quarter or half an	hour
quarter or more of	the
quarter section of land	in
quarter sessions for the	county
quarter sessions of the	peace county
quarter should be given	to
quarter the length of	the
quarter the size of	the
quarter to a half	of mile
quarter to a third	of
quarter to five in	the
quarter to half a	mile
quarter to half an	inch hour
quarter to one and	a
quarter to one half	of
quarter to one third	of
quarter to six in	the
quarter to three in	the
quarter turn to the	right left
quarter was asked or	given
quarter was given on	either
quarter was to be	given
quarterback on the football	team
quartered in any house	without
quartered in the house	of
quartering large bodies of	armed
quarterly data for the	period
quarters at the end	of
quarters at the house	of
quarters at the same	time
quarters for the night	in at
quarters in one of	the
quarters in the United	States
quarters in the house	of
quarters of a billion	dollars
quarters of a century	ago later of after before the earlier since have and in has to had old
quarters of a cup	of
quarters of a league	from
quarters of a mile	from in to long away wide of distant north south west east broad below above off and beyond across along on
quarters of a million	dollars people of pounds men in sterling tons
quarters of a pint	of
quarters of a pound	of
quarters of a ton	of
quarters of an acre	of
quarters of an hour	to later before after in the of and for at from or we with on he late I ago had
quarters of an inch	in long thick wide to from of above below deep broad
quarters of an ounce	of
quarters of one per	cent
quarters of the United	States
quarters of the White	House
quarters of the city	and were
quarters of the cost	of
quarters of the eighteenth	century
quarters of the globe	and
quarters of the length	of
quarters of the members	of
quarters of the nineteenth	century
quarters of the population	of were
quarters of the seventeenth	century
quarters of the total	population number
quarters of the twentieth	century
quarters of the value	of
quarters of the way	through up down to around across
quarters of the world	and
quarters on the first	floor
quarters on the second	floor
quarters on the third	floor
quarters or more of	the
quarters the length of	the
quarts of milk a	day
quarts of milk per	day
quarts of water a	day
quarts of water to	a
quarts water to a	boil
quartz or other rock	in
quash or modify the	subpoena
quashed by the Court	of
quashed for want of	form
quashed on the ground	that
que ces formulaires aient	inclus
que dans le cas	de
que du point de	vue
que hicieron por mar	los
que je ne suis	pas
que la raison ne	connait
que le premier pas	qui
que se oponga a	la
que se refiere a	la
que vous avez bien	voulu
quebecois de recherche sur	la
queen and the duke	of
queen gave birth to	a
queen in her own	right
queen is said to	have
queen of the south	shall
queen was delivered of	a
quench all the fiery	darts
quench the fiery darts	of
quench the thirst of	the
quenched by the addition	of
quenched the violence of	fire
quenching of the fluorescence	of
querelle des anciens et	des
queries on rights and	licenses
query as to whether	the
quest for a better	life
quest for a new	diagnostic
quest for an understanding	of
quest for knowledge of	the
quest for the Golden	Fleece
quest for the Holy	Grail
quest for the good	life
quest for the historical	Jesus
quest for the meaning	of
quest for the origins	of
quest of the Golden	Fleece
quest of the Holy	Grail
quest of the historical	Jesus
question I am going	to
question I can not	answer
question I could not	answer
question I have to	ask
question I put to	him you
question I should like	to
question I want to	ask raise
question I wanted to	ask
question I would like	to
question about the ability	of
question about the accuracy	of
question about the adequacy	of
question about the effect	of
question about the effectiveness	of
question about the existence	of
question about the extent	to
question about the fact	that
question about the future	of
question about the identity	of
question about the importance	of
question about the meaning	of
question about the nature	of
question about the need	for
question about the number	of
question about the origin	of
question about the possibility	of
question about the propriety	of
question about the quality	of
question about the reality	of
question about the relation	between of
question about the relationship	between
question about the role	of
question about the source	of
question about the status	of
question about the truth	of
question about the use	of
question about the validity	of
question about the value	of
question about whether or	not
question addressed in this	chapter
question also arises as	to
question always arises as	to
question and answer in	the
question and answer session	with
question and fill in	the
question and the question	of
question appears to have	been
question are to be	found
question arises as to	whether the how what why which who where when
question arises at this	point
question arises here as	to
question arises in connection	with
question arises in regard	to
question arises in the	United
question arises of how	to the
question arises of whether	the
question arises to what	extent
question arises whether it	is
question arises whether or	not
question arises whether there	is are
question arises whether this	is
question arises with regard	to
question arises with respect	to
question arising as to	the
question arising out of	the
question arose as to	whether the what how who which
question arose in my	mind
question as a matter	of
question as a means	of
question as a result	of
question as far as	the
question as if it	were
question as it relates	to
question as one of	the
question as part of	the
question as that of	the
question as to how	the far much many to this we long it he a they these one and such
question as to just	what how
question as to the	nature validity origin extent right existence meaning effect propriety possibility value amount relative relation proper power exact identity cause best legality necessity advisability number degree time truth manner source fact real character precise true wisdom accuracy reality actual desirability ultimate interpretation future constitutionality importance use correctness mode relationship reason form date place sufficiency possible significance status authenticity legal general authority role rights need influence
question as to what	is the extent constitutes was he should would kind it are we they a I this
question as to when	the a
question as to where	the he
question as to whether	the or a it there this he they we these such an any one she I all in his some and you that our their to
question as to which	of is was
question as to who	was is should would shall the
question as to why	the he it a this they there we
question as well as	the
question asked at the	beginning
question at issue between	the
question at issue here	is
question at issue in	the this
question at issue is	whether not the
question at issue was	whether the not
question at once arises	as whether
question at the beginning	of
question at the bottom	of
question at the end	of
question at the head	of
question at the heart	of
question at the present	time
question at the request	of
question at the right	time
question at the same	time
question at the time	of
question at the top	of
question at this point	is
question be answered in	the
question be referred to	the
question before the American	people
question before the Court	was is
question before the House	is was
question before the Supreme	Court
question before the court	was is
question before us is	whether not how the
question before us now	is
question being put on	the
question beyond the scope	of
question brings us back	to
question brings us to	the
question but that he	was
question but that it	is was
question by looking at	the
question by means of	a
question by pointing out	that
question by saying that	the
question by the fact	that
question came to a	head
question came up as	to
question came up for	discussion
question came up in	the
question can arise as	to
question can be answered	by in only with
question can be asked	about of in whether
question can be found	in
question can be put	in
question can be raised	as whether about
question can best be	answered
question can no longer	be
question can not be	answered settled decided solved resolved given considered avoided regarded
question can not yet	be
question can only be	answered settled
question comes up as	to
question concerning the existence	of
question concerning the meaning	of
question concerning the nature	of
question concerning the origin	of
question concerning the possibility	of
question concerning the relationship	between
question concerning the validity	of
question concerns the extent	to
question concerns the nature	of
question concerns the relationship	between
question could be answered	by
question could not be	answered
question could not have	been
question deeply interesting to	the
question did not seem	to
question does not admit	of
question does not appear	to
question does not apply	to
question does not arise	in
question does not have	a
question does not relate	to
question does not seem	to
question exists as to	whether
question for a long	time
question for all of	us
question for consideration is	whether
question for decision is	whether
question for decision was	whether
question for determination is	whether
question for each of	the
question for me to	answer
question for the Supreme	Court
question for the United	States
question for the consideration	of
question for the court	is was to
question for the decision	of
question for the determination	of
question for the first	time
question for the future	is of
question for the jury	to whether was
question for the opinion	of
question for the purpose	of
question for the sake	of
question for the time	being
question for the trier	of
question for us is	whether not
question for us to	consider decide
question for which there	is
question for you to	decide ask
question forces itself upon	us
question frequently arises as	to
question from a different	angle
question from another point	of
question from one of	the
question from the perspective	of
question from the point	of
question from the standpoint	of
question from the viewpoint	of
question from this point	of
question from time to	time
question goes to the	heart
question had arisen as	to
question had been put	to
question had been raised	in as
question had not yet	been
question had nothing to	do
question had to be	answered asked decided settled
question had to do	with
question hanging in the	air
question has already been	answered discussed
question has also been	raised
question has arisen as	to
question has arisen whether	the
question has been addressed	by
question has been answered	in by
question has been asked	whether by and in
question has been dealt	with
question has been discussed	in by
question has been much	discussed
question has been one	of
question has been put	to
question has been raised	as whether in by about
question has been the	subject
question has been whether	the
question has given rise	to
question has not been	answered settled
question has not yet	been
question has nothing to	do
question has often been	asked raised
question has to be	asked answered raised considered
question has to do	with
question has yet to	be
question having to do	with
question he could not	answer
question he had put	to
question here is not	whether the one of
question here is one	of
question here is whether	the or a there
question him as to	the his
question him on the	subject
question how far it	is
question how much of	the
question hung in the	air
question if you do	not
question immediately arises as	to
question in a different	way
question in a manner	that
question in a number	of
question in a slightly	different
question in a way	that
question in accordance with	the
question in all its	bearings aspects
question in any court	on of
question in connection with	the
question in dispute between	the
question in each case	is
question in every case	is
question in favor of	the
question in favour of	the
question in feminism and	the
question in her mind	that
question in his mind	that was
question in his own	mind
question in its own	right
question in light of	the
question in my mind	that as but about is whether was
question in my own	mind
question in reference to	the
question in regard to	the
question in relation to	the
question in so far	as
question in such a	way case
question in such cases	is
question in terms of	the a
question in that case	was
question in the House	of
question in the United	States
question in the absence	of
question in the affirmative	and
question in the case	of is was
question in the context	of
question in the course	of
question in the face	of
question in the field	of
question in the first	place instance
question in the following	way manner
question in the form	of
question in the hands	of
question in the history	of
question in the light	of
question in the mind	of
question in the minds	of
question in the negative	and
question in the next	chapter section
question in the presence	of
question in the present	case
question in the same	way
question in the sense	that
question in the space	provided
question in the study	of
question in the theory	of
question in the title	of
question in these cases	is
question in this case	is was
question in this chapter	is
question in this connection	is
question in this context	is
question in this regard	is
question in view of	the
question in which we	are
question in your own	words
question inevitably arises as	to
question involved in the	case
question involved in this	case
question is a difficult	one
question is a fair	one
question is a good	one
question is a matter	of
question is a question	of
question is a serious	one
question is a simple	one
question is addressed in	the
question is all the	more
question is an important	one
question is an open	one
question is answered by	the
question is answered in	the
question is as to	the whether what how
question is asked as	to
question is asked in	the
question is asked whether	the
question is asking you	to
question is at the	heart
question is based on	the a
question is best answered	by
question is beyond the	scope
question is bound up	with
question is by no	means
question is closely connected	with
question is closely related	to
question is complicated by	the
question is concerned with	the
question is connected with	the
question is contained in	the
question is dealt with	in
question is determined by	the
question is difficult to	answer
question is discussed in	the
question is easy to	answer
question is far from	being
question is followed by	a
question is found in	the
question is further complicated	by
question is given by	the
question is given in	the
question is going to	be
question is hard to	answer
question is how best	to
question is how can	we
question is how do	we you
question is how far	the
question is how much	of
question is how to	get make do determine find achieve
question is how we	can are
question is impossible to	answer
question is in the	affirmative negative
question is largely one	of
question is likely to	be
question is merely one	of
question is more difficult	to
question is more important	than
question is more likely	to
question is no longer	whether one
question is not a	simple question
question is not about	the
question is not an	easy
question is not answered	by
question is not as	to simple
question is not at	all
question is not before	us
question is not difficult	to
question is not easily	answered
question is not easy	to
question is not free	from
question is not how	to much many
question is not in	the
question is not likely	to
question is not merely	one
question is not of	the
question is not one	of that
question is not simply	whether
question is not so	much simple easy easily
question is not that	of
question is not to	be
question is not what	the is we
question is not whether	the we a there to it or you they this he one these such an
question is not yet	settled
question is of great	importance
question is often asked	whether
question is often raised	as whether
question is on agreeing	to
question is on the	adoption motion
question is one for	the
question is one in	which
question is one of	the fact great degree a law
question is one that	is can
question is one to	which
question is one which	is
question is only one	of
question is or is	not
question is part of	the a
question is posed as	to
question is provided by	the
question is put to	the him
question is raised about	the
question is raised as	to
question is raised by	the
question is raised concerning	the
question is raised in	the
question is raised whether	the
question is really one	of
question is referred to	the
question is related to	the
question is said to	be
question is similar to	the
question is simply one	of
question is simply whether	the
question is still an	open
question is still to	be
question is suggested by	the
question is supposed to	be
question is taken up	in
question is that it	is
question is that of	the a
question is that there	is
question is the degree	to of
question is the effect	of
question is the extent	to
question is the fact	that
question is the key	to
question is the most	important
question is the nature	of
question is the one	that
question is the only	one
question is the problem	of
question is the question	of
question is the relationship	between
question is the same	as
question is the subject	of
question is to answer	it
question is to ask	whether
question is to be	found answered decided determined put settled considered
question is to determine	the whether
question is to examine	the
question is to find	out
question is to know	whether
question is to look	at
question is to say	that
question is to what	extent degree
question is what are	the
question is what happens	to
question is what is	the
question is what its	proponent
question is what kind	of
question is what sort	of
question is what to	do
question is whether a	person
question is whether and	how to
question is whether any	of
question is whether he	is has
question is whether in	the
question is whether it	is will can was would has should
question is whether one	can
question is whether or	not
question is whether such	a
question is whether the	defendant United new state plaintiff same government two
question is whether there	is are was
question is whether they	are will can have
question is whether this	is
question is whether we	can are should have shall will
question is whether you	can are
question is which of	the these
question it is important	to
question it is necessary	to
question it will be	necessary
question leads us to	the
question lies at the	heart
question lies in the	fact
question mark at the	end
question mark in the	margin
question mark or an	exclamation
question mark or exclamation	point
question marks and exclamation	points
question may arise as	to
question may arise whether	the
question may be answered	by in
question may be asked	whether as why in of
question may be found	in
question may be put	in
question may be raised	as whether about
question may be regarded	as
question may be said	to
question may now be	asked
question may or may	not
question may well be	asked raised
question might arise as	to
question might be raised	as whether
question might well be	asked raised
question must be answered	in by
question must be asked	whether
question must be decided	by
question must be determined	by
question must be in	the
question must be left	to open
question must be raised	as whether
question must be regarded	as
question naturally arises as	to
question naturally arises whether	the
question naturally arose as	to
question needs to be	asked answered addressed
question not only of	the
question not so much	of
question now arises as	to
question now arises whether	the
question now arose as	to
question now before the	House
question now before us	is
question now is how	to
question now is whether	the this
question now to be	considered decided
question now was how	to
question now was whether	the
question of Church and	State
question of a change	of in
question of a few	years days hours
question of a future	life
question of a return	to
question of a short	time
question of a successor	to
question of access to	the
question of being able	to
question of burden of	proof
question of calling a	convention
question of cause and	effect
question of changes in	the
question of compensation for	the
question of confidence in	the
question of construction of	the
question of control of	the
question of dealing with	the
question of dollars and	cents
question of fact and	law not degree the
question of fact as	to
question of fact for	the a
question of fact in	each the
question of fact or	law
question of fact to	be
question of fact whether	the a
question of finding the	right
question of first impression	in
question of free will	and
question of freedom of	the
question of freedom or	slavery
question of getting rid	of
question of good and	evil
question of good or	bad
question of great importance	to
question of guilt or	innocence
question of his guilt	or
question of his right	to
question of how and	why when where
question of how best	to
question of how far	the a it this we
question of how it	is was
question of how large	a
question of how long	the it a
question of how many	people of
question of how much	of the to money time is a we
question of how one	can should might
question of how such	a
question of how the	two
question of how they	are
question of how to	deal make get define treat interpret handle live determine achieve measure use reconcile understand respond provide evaluate do find improve represent bring organize create manage account keep ensure maintain distinguish prevent develop be relate balance explain obtain
question of how we	can are should know might
question of how well	the
question of human rights	in and
question of interest here	is
question of interest is	whether
question of interest to	the
question of interpretation of	the
question of its relation	to
question of just how	much
question of law and	fact order
question of law arising	in out
question of law as	to
question of law for	the
question of law in	the
question of law is	involved
question of law or	fact of
question of law to	be the
question of life after	death
question of life and	death
question of life or	death
question of loyalty to	the
question of more or	less
question of one of	the
question of our relations	with
question of ownership of	the
question of participation in	the
question of peace and	war
question of peace or	war
question of point of	view
question of profit and	loss
question of proximity and	degree
question of recognition of	the
question of relations between	the
question of relations with	the
question of representation in	the
question of responsibility for	the
question of right and	wrong
question of right or	wrong
question of setting up	a
question of slavery and	the
question of slavery in	the
question of so much	importance
question of sovereignty over	the
question of success or	failure
question of succession to	the
question of supply and	demand
question of the Corn	Laws
question of the Holy	Places
question of the Irish	Church
question of the Spanish	succession
question of the United	States
question of the ability	of
question of the abolition	of
question of the acceptability	of
question of the acceptance	of
question of the accession	of
question of the accuracy	of
question of the acquisition	of
question of the action	of
question of the adequacy	of
question of the administration	of
question of the admissibility	of
question of the admission	of
question of the adoption	of
question of the advisability	of
question of the age	of
question of the allocation	of
question of the amount	of
question of the annexation	of
question of the antiquity	of
question of the applicability	of
question of the application	of
question of the appointment	of
question of the appropriateness	of
question of the attitude	of
question of the authenticity	of
question of the authority	of
question of the authorship	of
question of the autonomy	of
question of the availability	of
question of the balance	of between
question of the basis	of
question of the being	of
question of the best	method
question of the boundaries	of
question of the boundary	between
question of the burden	of
question of the capacity	of
question of the cause	of
question of the causes	of
question of the character	of and
question of the choice	of
question of the classification	of
question of the compatibility	of
question of the competence	of
question of the competency	of
question of the composition	of
question of the condition	of
question of the conditions	of under
question of the conduct	of
question of the connection	between
question of the consequences	of
question of the consistency	of
question of the constitution	of
question of the constitutionality	of
question of the construction	of
question of the content	of
question of the continuance	of
question of the continuity	of
question of the contribution	of
question of the control	of
question of the correctness	of
question of the cost	of
question of the creation	of
question of the credibility	of
question of the date	of
question of the day	was is
question of the death	penalty
question of the defence	of
question of the definition	of
question of the degree	of to
question of the delimitation	of
question of the dependence	of
question of the desirability	of
question of the destruction	of
question of the determination	of
question of the development	of
question of the dictatorship	of
question of the difference	between
question of the direction	of
question of the disposal	of
question of the disposition	of
question of the distinction	between
question of the distribution	of
question of the division	of
question of the duration	of
question of the duty	of
question of the education	of
question of the effect	of on
question of the effectiveness	of
question of the effects	of
question of the efficacy	of
question of the efficiency	of
question of the election	of
question of the emancipation	of
question of the emergence	of
question of the employment	of
question of the end	of
question of the equality	of
question of the essence	of
question of the establishment	of
question of the eternity	of
question of the ethics	of
question of the evacuation	of
question of the evolution	of
question of the exclusion	of
question of the exercise	of
question of the existence	of or and
question of the expansion	of
question of the expediency	of
question of the extension	of
question of the extent	to of and
question of the fact	that
question of the fate	of
question of the feasibility	of
question of the first	importance
question of the form	of
question of the formation	of
question of the freedom	of
question of the function	of
question of the future	of status
question of the genesis	of
question of the genuineness	of
question of the government	of
question of the greatest	importance
question of the growth	of
question of the guilt	or of
question of the highest	importance
question of the historicity	of
question of the history	of
question of the hour	was
question of the identification	of
question of the identity	of
question of the immortality	of
question of the impact	of
question of the importance	of
question of the improvement	of
question of the incidence	of
question of the inclusion	of
question of the independence	of
question of the influence	of
question of the inheritance	of
question of the integration	of
question of the integrity	of
question of the intention	of
question of the interpretation	of
question of the introduction	of
question of the jurisdiction	of
question of the justice	of
question of the justification	of
question of the kind	of
question of the lack	of
question of the language	of
question of the law	of
question of the lawfulness	of
question of the legal	status
question of the legality	of
question of the legitimacy	of
question of the length	of
question of the level	of
question of the liability	of
question of the liberty	of
question of the limitation	of
question of the limits	of
question of the link	between
question of the location	of
question of the loss	of
question of the magnitude	of
question of the maintenance	of
question of the management	of
question of the manner	in of
question of the marriage	of
question of the meaning	of and
question of the means	of
question of the measure	of
question of the mechanism	of
question of the merits	of
question of the method	of
question of the mode	of
question of the morality	of
question of the nationality	of
question of the nature	of and
question of the navigation	of
question of the necessity	of for
question of the need	for to
question of the number	of
question of the objectivity	of
question of the occurrence	of
question of the ontological	status
question of the order	of
question of the ordination	of
question of the organisation	of
question of the organization	of
question of the origin	of and
question of the origins	of
question of the ownership	of
question of the part	played
question of the participation	of
question of the passage	of
question of the payment	of
question of the permanence	of
question of the place	of
question of the point	of
question of the policy	of
question of the position	of
question of the possession	of
question of the possibility	of
question of the power	of to
question of the powers	of
question of the practicability	of
question of the presence	of or
question of the preservation	of
question of the price	of
question of the primacy	of
question of the priority	of
question of the probability	of
question of the production	of
question of the proper	role
question of the proportion	of
question of the propriety	of
question of the protection	of
question of the provision	of
question of the purchase	of
question of the purpose	of
question of the quality	of
question of the quantity	of
question of the range	of
question of the rate	of
question of the rationality	of
question of the reality	of
question of the reasonableness	of
question of the recognition	of
question of the reduction	of
question of the reform	of
question of the regulation	of
question of the relation	of between
question of the relations	between of
question of the relationship	between of
question of the relationships	between
question of the relative	importance merits value
question of the release	of
question of the relevance	of
question of the reliability	of
question of the removal	of
question of the renewal	of
question of the repeal	of
question of the representation	of
question of the responsibility	of for
question of the restoration	of
question of the retention	of
question of the return	of
question of the revision	of
question of the right	of to
question of the rights	of and
question of the role	of and played
question of the safety	of
question of the sale	of
question of the salvation	of
question of the scope	of
question of the security	of
question of the selection	of
question of the sense	of
question of the separation	of
question of the settlement	of
question of the shape	of
question of the significance	of
question of the sincerity	of
question of the site	of
question of the size	of
question of the slave	trade
question of the source	of
question of the sources	of
question of the sovereignty	of
question of the specificity	of
question of the stability	of
question of the standard	of
question of the state	of
question of the status	of
question of the strength	of
question of the structure	of
question of the success	of
question of the succession	to was
question of the sufficiency	of
question of the suitability	of
question of the superiority	of
question of the supply	of
question of the supremacy	of
question of the survival	of
question of the taxation	of
question of the time	of
question of the timing	of
question of the transfer	of
question of the transmission	of
question of the treatment	of
question of the truth	of or
question of the type	of
question of the unification	of
question of the union	of
question of the uniqueness	of
question of the unity	of
question of the universality	of
question of the use	of
question of the usefulness	of
question of the utility	of
question of the utmost	importance
question of the validity	of or
question of the value	of
question of the viability	of
question of the violation	of
question of the way	in
question of the wisdom	of
question of the withdrawal	of
question of their relation	to
question of their right	to
question of this kind	is
question of time as	to
question of time before	the they he
question of time until	the
question of time when	the
question of title to	the
question of to what	extent
question of truth or	falsity
question of very great	importance
question of vital importance	to
question of war and	peace
question of war or	peace
question of ways and	means
question of what are	the
question of what can	be
question of what constituted	a
question of what constitutes	a the an
question of what could	be
question of what counts	as
question of what determines	the
question of what exactly	is
question of what happened	to
question of what happens	to when if
question of what is	the a to meant an good and right
question of what it	means is was meant
question of what kind	of
question of what kinds	of
question of what level	of
question of what makes	a
question of what may	be
question of what might	be
question of what ought	to
question of what role	the
question of what should	be
question of what sort	of
question of what to	do
question of what type	of
question of what types	of
question of what was	to the
question of what we	are mean can should
question of what will	happen
question of what would	happen be have
question of when and	how
question of when it	is
question of when life	begins
question of where and	how
question of where to	draw
question of whether a	particular person given man state new woman certain
question of whether an	individual
question of whether and	how to when
question of whether any	of
question of whether he	was is had should would could
question of whether in	the
question of whether it	is was would should can will could
question of whether one	can should is
question of whether or	not
question of whether she	was
question of whether such	a an
question of whether the	United defendant state government new two same law world use individual plaintiff person federal child
question of whether there	is are was should can were has exists
question of whether they	are should were would can have
question of whether this	is was
question of whether to	use
question of whether we	can should are have
question of which came	first
question of which is	the
question of which of	the these
question of which type	of
question of who are	the
question of who controls	the
question of who had	the
question of who has	the
question of who is	to the a responsible in
question of who or	what
question of who owns	the
question of who should	be pay have
question of who was	to the responsible
question of who we	are
question of who will	be
question of who would	be
question of why and	how
question of why it	is was
question of why so	many
question of why some	people
question of why there	is are
question of why we	should
question often arises as	to
question on account of	the
question on any other	point
question on the Order	Paper
question on the agenda	of
question on the basis	of
question on the ground	that of
question on the grounds	that
question on the lips	of
question on the minds	of
question on the part	of
question on the subject	of
question on which action	is
question on which there	is
question once and for	all
question one of the	most
question one way or	the
question open as to	whether
question or completes the	statement
question or series of	questions
question or set of	questions
question or two about	the
question ought not to	be
question ought to have	been
question out of the	way
question over and over	again
question posed at the	beginning outset end
question posed by the	title
question posed in the	title
question presented by this	case appeal
question presented here is	whether
question presented in this	case
question presented is whether	the a
question put to him	by in
question put to me	by
question raised as to	the
question raised at the	beginning
question raised in this	case
question referred to it	by
question regarding the nature	of
question remained as to	whether
question remains as to	whether how what the why
question remains open as	to
question remains to be	answered considered
question remains whether it	is
question remains whether or	not
question resolves itself into	this
question seems to be	whether that the
question seems to have	been
question seems to me	to
question shall be decided	by
question shall be determined	by
question shall be entered	on
question shall be referred	to
question shall be submitted	to
question should be answered	in
question should be dealt	with
question should be decided	by
question should be left	to
question should be put	to
question should be referred	to
question should be settled	by
question should be submitted	to
question so far as	the
question some of the	assumptions
question sometimes arises as	to
question still remains as	to
question still remains to	be
question still remains whether	the
question still to be	answered
question that I can	not
question that I want	to
question that I would	like
question that arises at	this
question that arises from	this the
question that arises here	is
question that arises in	the this connection
question that arises is	whether how what why the this
question that can be	answered asked raised
question that can not	be
question that can only	be
question that comes to	mind
question that concerns us	here
question that could be	asked answered
question that could not	be
question that had been	on bothering asked
question that had to	be
question that has arisen	in
question that has been	raised asked
question that has never	been
question that has not	been yet
question that has often	been
question that has to	be
question that has yet	to
question that he was	a
question that immediately arises	is
question that is being	asked
question that is likely	to
question that is often	asked
question that is to	be
question that it is	a the
question that it was	the a
question that it would	be
question that lies at	the
question that many of	the
question that may arise	in
question that may be	asked raised
question that might be	asked raised
question that must be	answered asked addressed raised considered
question that naturally arises	is
question that needed to	be
question that needs to	be
question that now arises	is
question that one of	the
question that ought to	be
question that presents itself	is
question that remains is	whether how
question that remains to	be
question that remains unanswered	is
question that should be	asked answered
question that some of	the
question that the United	States
question that then arises	is
question that there is	a
question that there was	a
question that this is	a the
question that was put	to
question that we can	not
question that we have	to
question that we need	to
question that we now	turn
question the ability of	the
question the accuracy of	the this his
question the adequacy of	the
question the answer to	which
question the applicability of	the
question the appropriateness of	the
question the assumption that	the
question the authenticity of	the
question the authority of	the
question the competence of	the
question the constitutionality of	the
question the correctness of	the
question the credibility of	the
question the degree to	which
question the effectiveness of	the
question the efficacy of	the
question the existence of	the a God
question the extent to	which
question the fact that	the
question the fairness of	the
question the genuineness of	the
question the good faith	of
question the idea that	the
question the importance of	the
question the integrity of	the
question the judgment of	the
question the justice of	the
question the legality of	the
question the legitimacy of	the
question the meaning of	the
question the motives of	the
question the nature of	the
question the need for	a the
question the possibility of	a
question the power of	the
question the propriety of	the
question the quality of	the
question the reality of	the
question the relevance of	the
question the reliability of	the
question the right of	the a
question the role of	the
question the significance of	the
question the sincerity of	the his
question the soundness of	the
question the status of	the
question the sufficiency of	the
question the truth of	the this what
question the use of	the
question the usefulness of	the
question the utility of	the
question the validity of	the a this his their such any these an
question the value of	the a such this
question the veracity of	the
question the very basis	of
question the very existence	of
question the very foundations	of
question the very idea	of
question the very nature	of
question the very notion	of
question the very possibility	of
question the viability of	the
question the way in	which
question the ways in	which
question the wisdom of	the this his a such their
question then arises as	to
question then arises of	how
question then arises whether	the
question then arose as	to
question then becomes how	to
question then becomes one	of
question then becomes whether	the
question then is how	to
question then is not	whether
question then is whether	the
question there can be	no
question therefore arises as	to
question therefore arises whether	the
question thus arises as	to
question to a vote	of
question to answer is	whether
question to ask about	the
question to ask at	this
question to ask here	is
question to ask is	whether how not what why
question to ask of	the
question to ask yourself	is
question to be addressed	is in here
question to be answered	is by in was here
question to be asked	is in about of here
question to be considered	is in was here
question to be dealt	with
question to be decided	by is was in on
question to be determined	is by in was
question to be discussed	in is
question to be examined	is
question to be posed	is
question to be put	to
question to be raised	is
question to be resolved	is by
question to be settled	by is was in
question to be solved	is
question to be submitted	to
question to consider is	whether
question to one of	the
question to put to	you
question to the Court	of
question to the Supreme	Court
question to the United	Nations
question to the attention	of
question to the best	of
question to the decision	of
question to the satisfaction	of
question to what extent	the
question to which I	have shall
question to which an	answer
question to which it	is
question to which the	answer
question to which there	is
question to which we	shall must will now have
question took her by	surprise
question took me by	surprise
question turned out to	be
question turns out to	be
question upon which there	is
question uppermost in the	minds
question was a matter	of
question was about to	be
question was actually asked	on
question was addressed to	the
question was answered by	the a
question was answered in	the
question was as to	the whether
question was asked about	the
question was asked as	to
question was asked by	the
question was asked in	the a
question was asked of	the
question was asked whether	the
question was brought before	the
question was by no	means
question was complicated by	the
question was considered by	the
question was debated in	the
question was decided by	the
question was decided in	the
question was discussed at	the
question was discussed by	the
question was discussed in	the
question was finally settled	by
question was followed by	a
question was going to	be
question was how best	to
question was how to	get do
question was included in	the
question was left to	the
question was no longer	whether
question was not asked	in
question was not one	of
question was not so	much
question was not to	be
question was not whether	the
question was one of	the
question was presented to	the
question was put and	the
question was put by	the
question was put in	the
question was put to	the him me a them her
question was raised about	the
question was raised as	to
question was raised at	the
question was raised by	the
question was raised in	the
question was raised whether	the
question was received in	Hindi
question was referred to	the a
question was set at	rest
question was settled by	the
question was submitted to	the
question was taken up	by
question was that of	the
question was the subject	of
question was then taken	on
question was to be	decided settled
question was what to	do
question was whether he	would could was should
question was whether it	was would
question was whether or	not
question was whether there	was
question was whether they	would
question we are concerned	with
question we can not	answer
question we have now	to
question we have to	ask consider answer decide
question we must answer	is
question we must ask	is ourselves
question we need to	ask answer
question we shall have	to
question we should ask	is
question we should be	asking
question we would like	to
question what to do	with
question whether a person	is
question whether and how	far
question whether and to	what
question whether any of	the
question whether he was	a
question whether it can	be
question whether it is	possible a not the better right necessary really worth true
question whether it might	not
question whether it should	be
question whether it was	not a the possible
question whether it will	be
question whether it would	be not
question whether or not	the a it there he they this to we such an these
question whether some of	the
question whether statutes embodying	them
question whether the United	States
question whether the concept	of
question whether the presence	of
question whether the use	of
question whether there are	any
question whether there can	be
question whether there had	been
question whether there has	been
question whether there is	a any an not such anything
question whether there should	be
question whether there was	a any
question whether they can	be
question whether they should	be
question whether this is	a the
question whether this or	that
question whether we are	to
question whether we ought	to
question which I can	not
question which I do	not
question which I put	to
question which arises here	is
question which arises in	this
question which arises is	whether
question which can be	answered
question which can not	be
question which can only	be
question which could not	be
question which had to	be
question which has already	been
question which has been	raised much asked
question which has not	been yet
question which has often	been
question which has to	be
question which is to	be
question which it is	not
question which it would	be
question which lies at	the
question which may be	asked
question which must be	answered asked decided left
question which naturally arises	is
question which needs to	be
question which now arises	is
question which of the	two
question which ought to	be
question which presents itself	is
question which relates to	the
question which remains to	be
question which should be	asked
question which then arises	is
question which was put	to
question which we can	not
question which we have	to
question which will be	discussed
question why it is	that
question will arise as	to
question will be addressed	in
question will be answered	in by
question will be considered	in
question will be dealt	with
question will be discussed	in later
question will be found	in
question will be taken	up
question will be whether	the
question will depend on	the
question will have to	be
question with a view	to
question with any degree	of
question with reference to	the
question with regard to	the
question with respect to	the
question with which I	began
question with which this	chapter
question with which we	are began started have
question within the context	of
question within the framework	of
question wording and practical	difficulties
question would appear to	be
question would arise as	to
question would be to	ask
question would be whether	the
question would have to	be
question would not have	been
question would seem to	be
question yet to be	answered
question you can not	answer
question you have to	ask
question you must ask	yourself
question you need to	ask
question you put to	me
question you should ask	yourself
question you want to	ask
questionable in light of	the
questionable in the light	of
questionable in view of	the
questionable whether or not	the
questionable whether there is	any
questioned as to the	cause
questioned as to what	he
questioned as to whether	he they the
questioned as to why	he
questioned by a number	of
questioned by one of	the
questioned by some of	the
questioned her as to	the
questioned him as to	the his
questioned him on the	subject
questioned in a court	of
questioned in any court	or of
questioned in any other	place Place
questioned in the House	of
questioned in the light	of
questioned in view of	the
questioned me as to	the
questioned on the basis	of
questioned on the ground	that of
questioned on the grounds	that
questioned on the subject	of
questioned the ability of	the
questioned the accuracy of	the
questioned the adequacy of	the
questioned the appropriateness of	the
questioned the authenticity of	the
questioned the authority of	the
questioned the constitutionality of	the
questioned the effectiveness of	the
questioned the existence of	a the
questioned the extent to	which
questioned the legality of	the
questioned the legitimacy of	the
questioned the need for	a the
questioned the power of	the
questioned the propriety of	the
questioned the reliability of	the
questioned the right of	the
questioned the sincerity of	the
questioned the use of	the
questioned the usefulness of	the
questioned the validity of	the this
questioned the value of	the
questioned the wisdom of	the this
questioned whether it would	be
questioned whether or not	the
questioned whether there is	any
questioning him as to	the
questioning initiated by law	enforcement
questioning look on his	face
questioning of the legitimacy	of
questioning of the nature	of
questioning of the role	of
questioning of the status	quo
questioning of the validity	of
questioning of the value	of
questioning on the part	of
questioning the accuracy of	the
questioning the authenticity of	the
questioning the authority of	the
questioning the extent to	which
questioning the legality of	the
questioning the legitimacy of	the
questioning the right of	the
questioning the validity of	the
questioning the value of	the
questioning the wisdom of	the
questionings Of sense and	outward
questionnaire and return it	to
questionnaire at the end	of
questionnaire for the assessment	of
questionnaire sent out by	the
questionnaire used in this	study
questionnaire was administered to	the a
questionnaire was mailed to	the
questionnaire was sent out	to
questionnaire was sent to	the all a
questionnaire which was sent	to
questionnaires were sent out	to
questionnaires were sent to	the
questions I can not	answer
questions I could not	answer
questions I put to	him
questions I want to	ask
questions I wanted to	ask
questions I would like	to
questions about each of	the
questions about his or	her
questions about how and	why
questions about how best	to
questions about life and	death
questions about permissions can	be
questions about some of	the
questions about the United	States
questions about the ability	of
questions about the accuracy	of
questions about the adequacy	of
questions about the amount	of
questions about the applicability	of
questions about the application	of
questions about the appropriateness	of
questions about the authenticity	of
questions about the behavior	of
questions about the capacity	of
questions about the causes	of
questions about the character	of
questions about the concept	of
questions about the conduct	of
questions about the consequences	of
questions about the content	of
questions about the credibility	of
questions about the definition	of
questions about the degree	to of
questions about the desirability	of
questions about the details	of
questions about the development	of
questions about the direction	of
questions about the distribution	of
questions about the effect	of
questions about the effectiveness	of
questions about the effects	of
questions about the efficacy	of
questions about the ethics	of
questions about the evolution	of
questions about the existence	of
questions about the extent	to of
questions about the fate	of
questions about the feasibility	of
questions about the function	of
questions about the future	of
questions about the history	of
questions about the identity	of
questions about the impact	of
questions about the implications	of
questions about the importance	of
questions about the influence	of
questions about the integrity	of
questions about the interpretation	of
questions about the kind	of
questions about the kinds	of
questions about the legality	of
questions about the legitimacy	of
questions about the level	of
questions about the limits	of
questions about the location	of
questions about the meaning	of and
questions about the meanings	of
questions about the morality	of
questions about the nature	of and
questions about the need	for
questions about the number	of
questions about the operation	of
questions about the organization	of
questions about the origin	of and
questions about the origins	of
questions about the place	of
questions about the politics	of
questions about the possibility	of
questions about the power	of
questions about the process	of
questions about the propriety	of
questions about the purpose	of
questions about the quality	of
questions about the reasons	for
questions about the relation	between of
questions about the relations	between
questions about the relationship	between of
questions about the relationships	between
questions about the relevance	of
questions about the reliability	of
questions about the rights	of
questions about the role	of and
questions about the safety	of
questions about the scope	of
questions about the significance	of
questions about the source	of
questions about the sources	of
questions about the state	of
questions about the status	of
questions about the structure	of
questions about the sustainability	of
questions about the type	of
questions about the use	of
questions about the usefulness	of
questions about the utility	of
questions about the validity	of
questions about the value	of
questions about the very	nature
questions about the viability	of
questions about the way	in the
questions about the ways	in
questions about the wisdom	of
questions about this chapter	answered
questions about what had	happened
questions about what it	means is
questions about what kind	of
questions about what they	are
questions about what to	do
questions about what was	going
questions about whether or	not
questions addressed in this	chapter
questions addressed to him	by
questions affecting Russia as	will
questions affecting only individual	members
questions affecting the interests	of
questions affecting the rights	of
questions affecting the welfare	of
questions affecting the whole	people
questions and answers about	the
questions and answers from	the
questions and answers in	the
questions and answers of	the
questions and answers on	the
questions and book requests	to
questions and comments from	the
questions and concerns about	the
questions and issues of	the
questions and others like	them
questions and strifes of	words
questions and the answers	to
questions are addressed in	the this
questions are answered by	the
questions are answered in	the this
questions are asked about	the
questions are asked and	answered the
questions are asked by	the
questions are asked in	the a
questions are asked of	the
questions are at the	heart
questions are based on	the
questions are being asked	about
questions are being raised	about
questions are beyond the	scope
questions are by no	means
questions are dealt with	in
questions are designed to	help test
questions are difficult to	answer
questions are discussed in	the
questions are found in	the
questions are going to	be
questions are included in	the
questions are likely to	be
questions are more likely	to
questions are not easily	answered
questions are not easy	to
questions are not to	be
questions are put to	the
questions are raised about	the
questions are raised as	to
questions are raised by	the this
questions are related to	the
questions are relevant to	the
questions are similar to	those
questions are the subject	of
questions are to be	answered asked found decided
questions arise as to	the whether how what
questions arise at this	point
questions arise in connection	with
questions arise with regard	to
questions arise with respect	to
questions arising in connection	with
questions arising out of	the
questions arising within the	scope
questions arose as to	the
questions as a means	of
questions as a way	of
questions as completely as	possible
questions as if they	were
questions as part of	the
questions as the nature	of
questions as they relate	to
questions as to how	the to far
questions as to the	nature validity extent meaning origin right
questions as to what	the is he
questions as to whether	the or a it he they there
questions as to why	the
questions as well as	the to
questions as whether or	not
questions asked and the	answers
questions asked at the	beginning
questions asked by the	teacher
questions at issue between	the
questions at issue in	the
questions at the beginning	of
questions at the bottom	of
questions at the end	of
questions at the heart	of
questions at the right	time
questions at the same	time
questions at the top	of
questions based on its	content
questions began to be	asked
questions below consists of	a
questions between the two	countries
questions beyond the scope	of
questions can be answered	by in only with
questions can be asked	about of and in
questions can be found	in
questions can be raised	about
questions can be used	to as for
questions can not be	answered asked
questions can only be	answered
questions concerning the development	of
questions concerning the interpretation	of
questions concerning the meaning	of
questions concerning the nature	of and
questions concerning the origin	of
questions concerning the relation	of
questions concerning the relationship	between
questions concerning the role	of
questions concerning the status	of
questions concerning the use	of
questions concerning the validity	of
questions connected with the	subject
questions could be answered	by
questions could be asked	about
questions could be raised	about
questions could not be	answered
questions dealt with in	the this
questions do you have	about
questions during the course	of
questions for each of	the
questions for the purpose	of
questions for the sake	of
questions for which answers	are
questions for which there	are is
questions for you to	answer consider
questions from members of	the
questions from the perspective	of
questions from the point	of
questions from the standpoint	of
questions from time to	time
questions going to the	merits
questions growing out of	the
questions had to be	answered asked
questions had to do	with
questions has to do	with
questions have arisen as	to
questions have been answered	in
questions have been asked	about and
questions have been dealt	with
questions have been raised	about as concerning in by regarding
questions have not been	answered
questions have not yet	been
questions have to be	answered asked considered
questions have to do	with
questions have yet to	be
questions having to do	with
questions he could not	answer
questions he wanted to	ask
questions if you do	not
questions in a manner	that
questions in a variety	of
questions in a way	that
questions in accordance with	the
questions in an attempt	to
questions in an effort	to
questions in connection with	the
questions in dispute between	the
questions in each of	the
questions in mind as	you
questions in order to	get
questions in regard to	the
questions in relation to	the
questions in such a	way
questions in terms of	the
questions in the House	of
questions in the United	States
questions in the area	of
questions in the case	of
questions in the context	of
questions in the course	of
questions in the field	of
questions in the first	place
questions in the form	of
questions in the history	of
questions in the light	of
questions in the mind	of
questions in the minds	of
questions in the order	in
questions in the philosophy	of
questions in the same	way order
questions in the space	provided
questions in the spaces	provided
questions in the study	of
questions in the theory	of
questions in this section	are
questions in your own	words
questions is in the	affirmative
questions is one of	the
questions is to be	found
questions it is necessary	to
questions may arise as	to
questions may be answered	by in
questions may be asked	about of in
questions may be found	in
questions may be put	to
questions may be raised	about
questions may be used	to
questions most frequently asked	by
questions must be answered	in before by
questions must be asked	about and
questions must be raised	about
questions need to be	answered asked addressed considered raised
questions not only about	the
questions of a general	nature
questions of a legal	nature
questions of a more	general
questions of a personal	nature
questions of a similar	nature
questions of cause and	effect
questions of concern to	the
questions of economic and	social
questions of fact and	law questions of
questions of fact as	to well
questions of fact for	the
questions of fact or	law
questions of fact to	be
questions of faith and	morals
questions of foreign policy	and
questions of good and	evil
questions of how and	why
questions of how best	to
questions of interest to	the
questions of interpretation of	the
questions of law and	fact of questions
questions of law arising	in
questions of law for	the
questions of law or	fact
questions of law to	the
questions of life and	death
questions of peace and	war
questions of peace or	war
questions of public policy	and
questions of right and	wrong
questions of right or	wrong
questions of social and	economic political
questions of social equality	is
questions of sovereignty the	interests
questions of the day	and were in are
questions of the development	of
questions of the existence	of
questions of the greatest	importance
questions of the highest	importance
questions of the meaning	of
questions of the nature	of and
questions of the origin	of
questions of the present	day
questions of the relation	of
questions of the relationship	between
questions of the role	of
questions of the theory	of
questions of the utmost	importance
questions of the validity	of
questions of this kind	are
questions of this sort	are
questions of vital importance	to
questions of war and	peace
questions of what to	do
questions of whether and	how
questions of whether or	not
questions of why and	how
questions on a separate	sheet
questions on a sheet	of
questions on a variety	of
questions on the basis	of
questions on the ground	that
questions on the nature	of
questions on the next	page
questions on the part	of
questions on the subject	of
questions on the use	of
questions one at a	time
questions or any matters	within
questions or comments about	this
questions or concerns about	the
questions or incomplete statements	below
questions over and over	again
questions posed at the	beginning outset end
questions posed in the	introduction
questions put to her	by
questions put to him	by in
questions put to me	by
questions put to them	by in
questions raised at the	beginning
questions raised in this	chapter book
questions referred to it	by
questions regarding the nature	of
questions regarding the relationship	between
questions regarding the role	of
questions regarding the use	of
questions regarding the validity	of
questions relating to the	maintenance nature operation Security
questions remain as to	the whether
questions remain to be	answered
questions shall be decided	by
questions shall be made	by
questions she could not	answer
questions she wanted to	ask
questions should be answered	in by
questions should be asked	about in of and to
questions should be directed	to
questions should be put	to
questions similar to the	following
questions so that you	can
questions still need to	be
questions still remain to	be
questions still to be	answered
questions submitted to it	by
questions such as how	to
questions such as the	following
questions such as these	are that can will
questions such as whether	the
questions test your ability	to
questions than it has	answered
questions than to answer	them
questions that I can	not
questions that I could	not
questions that are asked	in of
questions that are being	asked
questions that are central	to
questions that are designed	to
questions that are difficult	to
questions that are important	to
questions that are likely	to
questions that are put	to
questions that are raised	by
questions that are relevant	to
questions that are to	be
questions that arise from	the
questions that arise in	the connection
questions that arise out	of
questions that arose in	the
questions that ask you	to
questions that can be	answered asked used raised addressed
questions that can not	be
questions that can only	be
questions that come to	mind
questions that come up	in
questions that could be	asked answered used
questions that could not	be
questions that do not	have
questions that focus on	the
questions that go beyond	the
questions that go to	the
questions that had been	raised asked
questions that had not	been
questions that had to	be
questions that have already	been
questions that have arisen	in
questions that have been	raised asked posed
questions that have not	been yet
questions that have to	be do
questions that he could	not
questions that lie at	the
questions that may arise	in
questions that may be	asked raised answered put
questions that might be	asked raised put
questions that must be	answered asked addressed considered
questions that need to	be
questions that needed to	be
questions that ought to	be
questions that pertain to	the
questions that relate to	the
questions that remain to	be
questions that require more	than
questions that require students	to
questions that should be	asked answered addressed considered
questions that should have	been
questions that we can	not
questions that we need	to
questions that were asked	of
questions that were put	to
questions that will be	asked addressed answered
questions that will have	to
questions that will help	you
questions that would be	asked
questions that would have	to
questions that you can	ask
questions that you do	not
questions that you may	have
questions that you might	ask have
questions that you need	to
questions that you should	ask
questions that you want	to
questions that you would	like
questions the answers to	which
questions the extent to	which
questions the validity of	the
questions the value of	the
questions they want to	ask
questions they would like	to
questions to ask about	the a
questions to ask and	how
questions to ask of	the
questions to ask yourself	when
questions to be addressed	in by are
questions to be answered	by in are and about before
questions to be asked	about of and in are by
questions to be considered	in are
questions to be dealt	with
questions to be decided	by
questions to be discussed	in
questions to be put	to
questions to be raised	about
questions to be settled	by
questions to be submitted	to
questions to be used	in
questions to do with	the
questions to find out	what
questions to help you	solidify
questions to keep in	mind
questions to make sure	that
questions to put to	the you
questions to the Court	of
questions to the best	of
questions to which answers	are
questions to which it	is
questions to which the	answers
questions to which there	are is
questions to which we	have
questions upon all other	parties
questions we ask and	the
questions we can not	answer
questions we have to	ask
questions we need to	ask
questions we would like	to
questions were answered by	the
questions were answered in	the
questions were asked about	the
questions were asked and	answered
questions were asked as	to
questions were asked by	the
questions were asked in	the Parliament
questions were asked of	the
questions were being asked	about
questions were included in	the
questions were put to	the him me
questions were raised about	the
questions were raised as	to
questions were raised by	the
questions were raised concerning	the
questions were raised in	the
questions were submitted to	the
questions were to be	asked answered
questions when you do	not
questions which I put	to
questions which are likely	to
questions which are put	to
questions which are to	be
questions which arise from	the
questions which arise in	the connection this
questions which arise out	of
questions which arose in	the
questions which can be	answered asked
questions which can not	be
questions which can only	be
questions which could not	be
questions which go to	the
questions which had been	raised
questions which had to	be
questions which have arisen	in
questions which have been	raised asked
questions which have not	been
questions which have to	be
questions which lie at	the
questions which may arise	in
questions which may be	asked raised
questions which might be	asked
questions which must be	answered asked
questions which need to	be
questions which ought to	be
questions which relate to	the
questions which remain to	be
questions which should be	asked answered
questions which we can	not
questions which were put	to
questions which were to	be
questions will ask you	to
questions will be addressed	in
questions will be answered	in by
questions will be considered	in
questions will be dealt	with
questions will be discussed	in
questions will be found	in
questions will be taken	up
questions will have to	be
questions will help you	to measure determine
questions will need to	be
questions with a view	to
questions with reference to	the
questions with regard to	the
questions with respect to	the
questions with which we	are began
questions within the context	of
questions would have to	be
questions would you like	to
questions yet to be	answered
questions you can ask	yourself
questions you can not	answer
questions you have about	the
questions you may be	asked
questions you may have	about
questions you may want	to
questions you might ask	yourself
questions you might have	about
questions you might want	to
questions you need to	ask answer
questions you should ask	yourself
questions you should be	asking
questions you want to	ask
questions you will be	asked
questions you will need	to
questions you wish to	ask
questions you would like	to
queue in front of	the
qui blandit praesent luptatum	zzril
qui facit per alium	facit
qui ne le sont	pas
qui potuit rerum cognoscere	causas
qui se trouvent dans	les
qui venit in nomine	Domini
quick action on the	part
quick and easy access	to
quick and easy method	of
quick and easy to	use make prepare
quick and easy way	to of
quick and easy ways	to
quick and the dead	at
quick and to the	point
quick as a flash	of
quick brown fox jumped	over
quick brown fox jumps	over
quick end to the	war
quick glance around the	room
quick glance at his	watch
quick glance at the	clock
quick glance over her	shoulder
quick glance over his	shoulder
quick kiss on the	cheek lips
quick look at some	of
quick look over his	shoulder
quick peck on the	cheek
quick shake of her	head
quick shake of his	head
quick to add that	the
quick to capitalize on	the
quick to jump on	the
quick to make use	of
quick to note that	the
quick to pick up	on the
quick to point out	that the to how in
quick to point this	out
quick to point to	the
quick to realize that	the
quick to recognize that	the
quick to respond to	the
quick to see that	the
quick to see the	advantages possibilities advantage
quick to seize on	the
quick to seize the	opportunity
quick to seize upon	the
quick to take advantage	of
quick to take up	the
quick understanding in the	fear
quicken the pace of	the
quicken your mortal bodies	by
quickened us together with	Christ
quickening of the pace	of
quicker than that of	the
quicker than you can	say
quickest and easiest way	to
quickest and most effective	way
quickest and surest way	to
quickest way to get	to a
quickly and accurately as	possible
quickly and as accurately	as
quickly and as cheaply	as
quickly and as completely	as
quickly and as easily	as
quickly and as efficiently	as
quickly and as quietly	as
quickly and at low	cost
quickly and cheaply as	possible
quickly and completely as	possible
quickly and easily as	possible
quickly and effectively as	possible
quickly and efficiently as	possible
quickly and painlessly as	possible
quickly and ql Contact	us
quickly and quietly as	possible
quickly and safely as	possible
quickly and went to	the
quickly and with a	minimum
quickly and with as	little
quickly as I could	and to
quickly as a result	of
quickly as he could	and to
quickly as he had	come appeared
quickly as it had	come begun appeared arisen risen started been arrived
quickly as possible after	the
quickly as possible and	to then the get with that
quickly as possible at	the
quickly as possible before	the
quickly as possible by	the
quickly as possible for	the
quickly as possible from	the
quickly as possible in	order the a
quickly as possible into	the
quickly as possible on	the
quickly as possible so	that as
quickly as possible through	the
quickly as possible to	the a avoid prevent get
quickly as possible with	the a
quickly as she could	and to
quickly as soon as	the
quickly as they could	to be
quickly as they had	come appeared
quickly as you can	and to
quickly at the beginning	of
quickly at the end	of
quickly at the sound	of
quickly attracted the attention	of
quickly became a part	of
quickly became apparent that	the
quickly became aware of	the
quickly became clear that	the
quickly became evident that	the
quickly became involved in	the
quickly became known as	the
quickly became obvious that	the
quickly became one of	the
quickly became part of	the
quickly became the center	of
quickly became the focus	of
quickly became the most	popular important
quickly become aware of	the
quickly become one of	the
quickly become out of	date
quickly becomes apparent that	the
quickly becoming one of	the
quickly came to an	end
quickly came to dominate	the
quickly came to realize	that
quickly came to the	conclusion
quickly closed the door	behind
quickly discovered that it	was
quickly earned a reputation	as
quickly enough to meet	the
quickly enough to prevent	the
quickly established a reputation	as for
quickly established himself as	a the one
quickly established itself as	a the
quickly fell in love	with
quickly followed by a	second
quickly followed by that	of
quickly found its way	into
quickly found their way	into
quickly from one place	to
quickly from one to	the
quickly from place to	place
quickly from side to	side
quickly gained a reputation	as for
quickly gave way to	a the
quickly get out of	hand
quickly got out of	the
quickly got to his	feet
quickly in and out	of
quickly in order to	avoid get
quickly in the United	States
quickly in the case	of
quickly in the direction	of
quickly in the event	of
quickly in the face	of
quickly in the opposite	direction
quickly in the presence	of
quickly into the streets	and
quickly learned that it	was
quickly lost interest in	the
quickly made a name	for
quickly made his way	to
quickly made it clear	that
quickly made their way	to
quickly made up his	mind
quickly moved out of	the
quickly on the basis	of
quickly on the heels	of
quickly one after the	other
quickly opened the door	and
quickly or not at	all
quickly out of the	room way
quickly picked up by	the
quickly pointed out that	the
quickly proved to be	a
quickly put a stop	to
quickly put an end	to
quickly realized that he	was
quickly realized that it	was
quickly rose through the	ranks
quickly sent directly to	you
quickly sized up the	situation
quickly so as not	to
quickly taken up by	the
quickly than in the	past
quickly than it can	be
quickly that I could	not
quickly that I did	not
quickly that he could	not
quickly that he did	not
quickly that there is	no
quickly that there was	no
quickly to changes in	the
quickly to his feet	and
quickly to take advantage	of
quickly to the conclusion	that
quickly to the door	and
quickly to the end	of
quickly to the heart	of
quickly to the other	side
quickly to the side	of
quickly to the top	of
quickly took advantage of	the
quickly took control of	the
quickly up and down	the
quickness of his wit	and
quid of tobacco in	his
quid pro quo and	hostile
quid pro quo for	the a their
quid pro quo from	the
quid pro quo in	the
quid pro quo of	the
quid pro quo sexual	harassment
quiet all of a	sudden
quiet and go to	sleep
quiet and out of	the
quiet and peace of	the
quiet and peaceable life	in
quiet and peaceable possession	of
quiet and still air	of
quiet by the power	Of
quiet enjoyment of the	premises
quiet except for the	sound
quiet for a couple	of
quiet for a day	or
quiet for a few	minutes moments seconds days
quiet for a little	while
quiet for a long	time moment while
quiet for a minute	or
quiet for a moment	and as
quiet for a short	time
quiet for a while	and
quiet for most of	the
quiet for so long	that
quiet for the rest	of
quiet for the time	being
quiet hours of the	night
quiet in the face	of
quiet in the midst	of
quiet in the presence	of
quiet life in the	country
quiet most of the	time
quiet on the Western	Front
quiet on the western	front
quiet past are inadequate	to
quiet place in which	to
quiet place where you	can will
quiet possession of the	goods
quiet so as not	to
quiet the apprehensions of	the
quiet the fears of	the
quiet the minds of	the
quiet the rest of	the
quiet time with the	Lord
quiet us in a	death
quietly as he had	come
quietly as if he	were had
quietly at the end	of
quietly by the side	of
quietly closed the door	behind
quietly closing the door	behind
quietly for a few	minutes moments seconds
quietly for a long	time
quietly for a moment	and
quietly in a corner	of
quietly in front of	the
quietly in the back	of
quietly in the corner	of
quietly in the living	room
quietly in the middle	of
quietly in the midst	of
quietly into the room	and
quietly on the edge	of
quietly opened the door	and
quietly out of the	room house way
quietly slipped out of	the
quietly so as not	to
quietly wait for the	salvation
quietness and assurance for	ever
quietness and confidence shall	be
quietness and in confidence	shall
quietus make With a	bare
quills upon the fretful	porcupine
quis nostrud exerci tation	ullamcorper
quit at the end	of
quit her job as	a
quit her job at	the
quit his job as	a
quit his job at	the
quit in the middle	of
quit my job at	the
quit our own to	stand
quit school and go	to
quit the service of	the
quit this part of	the
quit while he was	ahead
quite a bit about	the how it what you
quite a bit better	than
quite a bit different	from
quite a bit during	the
quite a bit from	the
quite a bit higher	than
quite a bit in	the common
quite a bit larger	than
quite a bit less	than
quite a bit longer	than
quite a bit lower	than
quite a bit more	than complicated
quite a bit of	time money the work information it trouble attention experience weight research effort space evidence damage that interest this variation
quite a bit older	than
quite a bit on	the
quite a bit over	the
quite a bit smaller	than
quite a bit to	say do the
quite a bit younger	than
quite a change from	the
quite a change in	the
quite a common thing	for to
quite a commotion in	the
quite a considerable amount	of
quite a considerable number	of
quite a contrast to	the
quite a departure from	the
quite a difference between	the
quite a difference in	the
quite a different approach	to
quite a different character	from
quite a different class	of
quite a different creature	from
quite a different direction	from
quite a different kind	of from
quite a different light	from
quite a different man	from
quite a different manner	from
quite a different matter	from to when
quite a different meaning	from
quite a different nature	from
quite a different one	from
quite a different order	from of
quite a different part	of
quite a different person	from
quite a different picture	of from
quite a different point	of
quite a different position	from
quite a different sense	from
quite a different set	of
quite a different sort	of
quite a different state	of
quite a different thing	from to when
quite a different type	of from
quite a different view	of
quite a different way	from than
quite a distance away	from
quite a distance from	the
quite a feature of	the
quite a few cases	of
quite a few examples	of
quite a few in	the
quite a few members	of
quite a few of	the them these us those his our my their which
quite a few people	who in
quite a few things	that to
quite a few times	in
quite a few years	ago now before to
quite a good deal	of
quite a good number	of
quite a high degree	of
quite a high level	of
quite a high proportion	of
quite a kick out	of
quite a large amount	of
quite a large body	of
quite a large group	of
quite a large number	of
quite a large part	of
quite a large percentage	of
quite a large portion	of
quite a large proportion	of
quite a large quantity	of
quite a large sum	of
quite a length of	time
quite a long list	of
quite a long period	of
quite a long talk	with
quite a long time	to before and ago in after for since now the
quite a long way	from off to
quite a lot about	the it
quite a lot from	the
quite a lot in	the common
quite a lot of	money time the people it work them things information trouble attention fun other good evidence him his this what that space
quite a lot to	do say be
quite a man of	the
quite a match for	the
quite a matter of	course indifference
quite a mistake to	suppose
quite a name for	himself
quite a number of	the people them years other cases these different men things times such our young new persons others instances his small books women those children places countries good us species important students interesting my
quite a period of	time
quite a quarter of	a an
quite a reputation as	a
quite a sensation among	the
quite a sensation in	the
quite a shock to	the me
quite a sight to	see
quite a simple matter	to
quite a small number	of
quite a stir among	the
quite a stir at	the
quite a stir in	the
quite a story to	tell
quite a stranger to	the
quite a sum of	money
quite a surprise to	me
quite a time of	it
quite a way from	the
quite a way to	go
quite a while after	the
quite a while and	then I
quite a while before	I he the they we
quite a while for	the
quite a while in	the
quite a while since	I
quite a while to	get
quite a wide range	of
quite a wide variety	of
quite a young man	he
quite able to look	after
quite able to take	care
quite accurate to say	that
quite after the manner	of
quite agree with him	that
quite agree with what	you
quite agree with you	that in about as there
quite alive to the	fact
quite alone in the	world
quite an easy matter	to
quite an impact on	the
quite an important part	in
quite an important role	in
quite an impression on	the me
quite an interest in	the
quite analogous to that	of
quite another for him	to
quite another part of	the
quite another point of	view
quite another thing from	the
quite another thing to	say be have make
quite another to be	able
quite another to say	that
quite apart from all	the
quite apart from any	question other consideration
quite apart from anything	else
quite apart from considerations	of
quite apart from questions	of
quite apart from that	of
quite apart from the	fact question other rest general actual problem obvious
quite as a matter	of
quite as bad as	the that it they
quite as easy as	it
quite as effective as	the
quite as far as	the that
quite as fast as	the
quite as good as	the that those any a it they his
quite as great a	degree
quite as great as	that the in
quite as high as	the that
quite as if he	had were
quite as if it	were
quite as if she	were had
quite as if they	were
quite as important as	the that any
quite as important to	the
quite as interesting as	the
quite as it should	be
quite as large as	the that
quite as likely to	be have
quite as long as	the
quite as much a	matter
quite as much as	the it to he in they a I his any by of for we you that she if their those on did from with upon is was does her do an its
quite as much at	home
quite as much by	the
quite as much for	the
quite as much from	the
quite as much in	the
quite as much interested	in
quite as much of	a the
quite as much on	the
quite as much out	of
quite as much so	as
quite as much to	the do be
quite as much upon	the
quite as often as	the
quite as old as	the
quite as remarkable as	the
quite as simple as	that it this the
quite as strong as	the that
quite as well as	the I he a any if you they in we she it his
quite as well in	the
quite aside from the	fact
quite at a loss	to what how for as
quite at ease in	the
quite at ease with	the
quite at his ease	in
quite at home among	the
quite at home in	the a this his
quite at home on	the
quite at home with	the
quite at liberty to	do
quite at odds with	the
quite at the beginning	of
quite at the end	of
quite at the mercy	of
quite at the other	end
quite at the top	of
quite at variance with	the his those that
quite aware of the	fact importance
quite aware that he	was
quite aware that it	is was
quite aware that there	are
quite beyond the bounds	of
quite beyond the capacity	of
quite beyond the comprehension	of
quite beyond the control	of
quite beyond the limits	of
quite beyond the power	of
quite beyond the powers	of
quite beyond the range	of
quite beyond the reach	of
quite beyond the scope	of
quite capable of carrying	out
quite capable of dealing	with
quite capable of doing	so
quite capable of looking	after
quite capable of making	a
quite capable of taking	care
quite carried away by	the
quite certain as to	the
quite certain that he	was would had is
quite certain that if	the
quite certain that in	the
quite certain that it	was is would
quite certain that no	one
quite certain that the	crimes
quite certain that there	is was are
quite certain that they	were are would
quite certain that this	is
quite clear as to	the what
quite clear from the	above
quite clear in his	mind own
quite clear in my	mind
quite clear on the	point
quite clear on this	point
quite clear that I	am
quite clear that he	was had is did would
quite clear that if	the
quite clear that in	the
quite clear that it	is was would
quite clear that she	was
quite clear that such	a
quite clear that there	is was are
quite clear that they	were are would had
quite clear that this	is was
quite clear that we	are can have
quite clear to him	that
quite clear to me	that
quite clear to the	reader
quite clear to them	that
quite clear to us	that
quite clearly that he	was
quite clearly that it	is was
quite clearly that there	is
quite close to each	other
quite close to one	another
quite close to that	of
quite close to the	surface ground shore actual house
quite close to those	of
quite closely related to	the
quite come to terms	with
quite come up to	the
quite common for people	to
quite common in the	United
quite common to find	that a
quite comparable to that	of
quite comparable to those	of
quite compatible with the	principle
quite conscious of the	fact
quite content to leave	the
quite content to let	the
quite contrary to that	of
quite contrary to the	spirit
quite convinced that it	was
quite correct in saying	that
quite correct to say	that
quite correct to speak	of
quite cut off from	the
quite dark by the	time
quite different and much	more
quite different approach to	the
quite different approaches to	the
quite different because of	the
quite different depending on	the whether
quite different for the	two
quite different from all	the other
quite different from any	other of that
quite different from anything	that I we
quite different from each	other
quite different from either	of
quite different from his	own
quite different from most	of
quite different from my	own
quite different from one	another
quite different from our	own
quite different from saying	that
quite different from that	of in which for used found on at given observed seen to described obtained
quite different from the	one other way usual original others traditional rest first ones more old ordinary situation present previous earlier normal kind actual case typical conventional standard common former modern English same simple world two general American classical type preceding average
quite different from their	own
quite different from those	of in which that used for found we on obtained who at they with he to required
quite different from what	it they we the he I is you was one she had has
quite different in appearance	from
quite different in character	from
quite different in each	case
quite different in form	from
quite different in kind	from
quite different in many	respects
quite different in nature	from
quite different in terms	of
quite different in the	two case
quite different in these	two
quite different in this	respect
quite different parts of	the
quite different point of	view
quite different points of	view
quite different than in	the
quite different than that	of
quite different than those	of
quite different to that	of
quite different to those	of
quite different view of	the
quite different views of	the
quite different ways in	which
quite different with regard	to
quite different with respect	to
quite differently from the	way
quite difficult to determine	the
quite distinct from any	other
quite distinct from each	other
quite distinct from one	another
quite distinct from that	of which
quite distinct from the	other rest ordinary others question
quite distinct from those	of
quite early in his	career
quite early in the	morning history day century
quite early on in	the
quite easy for him	to
quite easy for me	to
quite easy in his	mind
quite easy to see	that how
quite easy to show	that
quite enough for me	to
quite enough for one	day
quite enough to account	for
quite enough to do	to in with
quite enough to make	the
quite enough to show	that
quite equal to that	of
quite equal to the	occasion task best
quite equal to those	of
quite evident that he	was had
quite evident that it	is was
quite evident that there	is
quite evident that they	were
quite evident to me	that
quite exempt from any	intellectual
quite explicit on this	point
quite fair to say	that
quite far away from	the
quite far removed from	the
quite fit in with	the
quite foreign to his	nature
quite general and can	be
quite get the hang	of
quite good agreement with	the
quite good enough for	the me
quite good enough to	be
quite got the hang	of
quite ignorant of the	fact
quite impossible for any	one
quite impossible for her	to
quite impossible for him	to
quite impossible for me	to
quite impossible for them	to
quite impossible for us	to
quite impossible for you	to
quite impossible that he	should
quite impossible to believe	that
quite impossible to describe	the
quite impossible to say	that
quite in a position	to
quite in a state	of
quite in accord with	the
quite in accordance with	the his what this
quite in agreement with	the
quite in character with	the
quite in conformity with	the
quite in consonance with	the
quite in contrast to	the
quite in contrast with	the
quite in harmony with	the
quite in keeping with	the his this what their
quite in line with	the
quite in the dark	as about
quite in the line	of
quite in the manner	of
quite in the nature	of
quite in the order	of
quite in the same	way
quite in the spirit	of
quite in the style	of
quite in the vein	of
quite in the way	that
quite in tune with	the
quite inadequate to account	for
quite inadequate to meet	the
quite incapable of dealing	with
quite independent of each	other
quite independent of one	another
quite independent of that	of
quite independent of the	other question
quite independently of each	other
quite independently of one	another
quite independently of the	other
quite indifferent as to	the whether
quite interesting to note	that
quite justified in saying	that
quite knew what to	do
quite knew what was	happening
quite know how to	handle put take say go
quite know what it	is was
quite know what to	do make say think expect
quite know what you	mean
quite knowing what to	do expect say
quite large compared to	the
quite late in the	evening afternoon day
quite like it in	the
quite like that of	the
quite like the idea	of
quite like those of	the
quite likely that he	would was
quite likely that in	the
quite likely that it	was
quite likely that many	of
quite likely that some	of
quite likely that they	will
quite likely that you	will
quite likely to be	the a
quite likely to have	been
quite live up to	the
quite long periods of	time
quite lost sight of	the
quite made up her	mind
quite made up his	mind
quite made up my	mind
quite made up their	minds
quite made up your	mind
quite make it to	the
quite make out what	it
quite make up her	mind
quite make up his	mind
quite make up my	mind
quite measure up to	the
quite natural for him	to
quite natural for them	to
quite natural that I	should
quite natural that he	should
quite natural that it	should
quite natural that she	should
quite natural that they	should
quite natural that we	should
quite natural that you	should
quite natural to assume	that
quite natural to suppose	that
quite naturally out of	the
quite oblivious of the	fact
quite obvious that he	was
quite obvious that it	is
quite obvious that there	is
quite obvious to me	that
quite of a piece	with
quite of the same	opinion
quite often the case	that
quite old enough to	be
quite on a level	with
quite on a par	with
quite on the cards	that
quite on the other	side
quite one of the	most best
quite opposite to that	of
quite other than that	of
quite out of character	with for
quite out of harmony	with
quite out of his	mind element
quite out of keeping	with
quite out of line	with
quite out of my	power
quite out of place	in here to
quite out of proportion	to with
quite out of reach	of
quite out of sight	of
quite out of sympathy	with
quite out of the	question ordinary way common reach blue world range
quite out of touch	with
quite out of tune	with
quite outside the range	of
quite outside the scope	of
quite pleased with the	results
quite possible for a	man person
quite possible for him	to
quite possible for them	to
quite possible for us	to
quite possible that I	may
quite possible that he	was may had might would
quite possible that if	the
quite possible that in	the some a
quite possible that it	was may is
quite possible that many	of
quite possible that one	of
quite possible that some	of
quite possible that such	a
quite possible that the	same two
quite possible that there	may are is was were
quite possible that they	may were are will would
quite possible that this	is was
quite possible that we	may
quite possible that you	will may
quite possible to argue	that
quite possible to conceive	of
quite possible to have	a
quite possible to make	a
quite prepared to accept	the
quite prepared to admit	that
quite prepared to believe	that
quite probable that in	the
quite probable that some	of
quite proud of the	fact
quite put her finger	on
quite put his finger	on
quite put my finger	on
quite put your finger	on
quite ready and willing	to
quite ready to accept	the
quite ready to admit	that
quite ready to believe	that
quite ready to do	so
quite ready to give	up
quite ready to go	to
quite ready to take	the
quite reasonable to assume	that
quite reasonable to expect	that
quite reasonable to suppose	that
quite recovered from the	shock effects
quite red in the	face
quite regardless of the	fact
quite right in his	head
quite right in pointing	out
quite right in saying	that
quite right in supposing	that
quite right in the	head
quite right in thinking	that
quite right to do	so
quite right to point	out
quite right to say	that
quite right when he	said says
quite rightly points out	that
quite safe to assume	that
quite safe to say	that
quite satisfied with the	result way results
quite see it that	way
quite sensitive to changes	in
quite separate and distinct	from
quite separate from each	other
quite separate from that	of
quite similar in appearance	to
quite similar in terms	of
quite similar in the	two
quite similar to each	other
quite similar to one	another
quite similar to that	of in for which used found described observed
quite similar to the	one ones previous
quite similar to those	of in for found used obtained which that observed reported described
quite simple and can	be
quite small compared to	the
quite small compared with	the
quite small in comparison	with to
quite small in relation	to
quite small relative to	the
quite so bad as	that the it
quite so close to	the
quite so far as	that to the this
quite so good as	the
quite so large as	the
quite so long as	the
quite so much as	the
quite so much of	a
quite so simple as	that it this
quite so well as	the
quite some distance from	the
quite some time after	the
quite some time before	the he I
quite some time in	the
quite some time to	come
quite still for a	moment
quite such a fool	as
quite sufficient for the	purpose
quite sufficient to account	for
quite sufficient to explain	the
quite sufficient to prove	that
quite sufficient to show	that
quite sure as to	the
quite sure he did	not
quite sure he would	not
quite sure how to	take
quite sure it is	not
quite sure it was	not
quite sure of his	ground
quite sure of what	he
quite sure that I	should was have shall am would could had
quite sure that he	was would had is will has did could
quite sure that if	I the
quite sure that in	the
quite sure that it	is was would will
quite sure that no	one
quite sure that she	was had would
quite sure that there	is was are
quite sure that they	are were would will
quite sure that this	is was
quite sure that we	are have
quite sure that you	will are have would
quite sure what he	was meant
quite sure what it	was is
quite sure what she	was
quite sure what to	do make say expect
quite sure whether he	was
quite sure whether it	was is
quite sure whether or	not
quite sure you do	not
quite sure you will	not
quite surprised to find	that
quite surprised to learn	that
quite taken aback by	the
quite the air of	a
quite the appearance of	a
quite the contrary is	true the
quite the end of	the
quite the equal of	the
quite the opposite is	true the
quite the opposite of	the what that a those
quite the opposite was	true
quite the other way	around
quite the reverse is	true
quite the reverse of	the what that
quite the same after	that
quite the same as	the that those in a it before saying they when
quite the same degree	of
quite the same extent	as
quite the same in	the
quite the same kind	of
quite the same manner	as
quite the same sense	as
quite the same sort	of
quite the same thing	as
quite the same way	as that again in
quite to be expected	that
quite to the bottom	of
quite to the end	of
quite to the level	of
quite to the point	of
quite to the same	extent
quite took my breath	away
quite true that I	have
quite true that in	the
quite true that it	is
quite true that there	is are
quite true to say	that
quite unable to account	for
quite unable to cope	with
quite unable to deal	with
quite unable to do	so anything
quite unable to resist	the
quite unable to understand	the
quite unaware of the	fact
quite unconscious of the	fact
quite understand what you	mean
quite understandable in view	of
quite unequal to the	task
quite unlike any of	the
quite unlike anything else	in
quite unlike that of	the any
quite unlike those of	the
quite unnecessary for me	to
quite untrue to say	that
quite up to the	mark standard level average task
quite useless to attempt	to
quite well aware of	the
quite well in terms	of
quite well known in	the
quite well known to	the
quite well that he	was
quite well that it	was is
quite well what he	was
quite what I had	in
quite what it had	been
quite what to do	with about
quite what to make	of
quite wide of the	mark
quite willing to accept	the
quite willing to admit	that
quite willing to believe	that
quite willing to do	so
quite willing to give	up
quite willing to leave	the
quite willing to let	the
quite willing to pay	for
quite willing to take	the
quite willing to talk	about
quite within the bounds	of
quite within the limits	of
quite within the power	of
quite within the range	of
quite within the reach	of
quite within the realm	of
quite work out that	way
quite wrong to assume	that
quite wrong to say	that
quite wrong to suggest	that
quite wrong to suppose	that
quite wrong to think	that of
quite young at the	time
quitted the service of	the
quitting the subject of	the
quitting this part of	the
quivering from head to	foot
quiz at the end	of
quiz questions to help	you
quizzical expression on his	face
quizzical look on her	face
quizzical look on his	face
quo in the Far	East
quo in the Middle	East
quo in the form	of
quod non prius fuerit	in
quod non prius in	sensu
quorum at a meeting	of
quorum at any meeting	of
quorum for a meeting	of
quorum for any meeting	of
quorum for the purpose	shall
quorum for the transaction	of
quorum for this Purpose	shall
quorum for this purpose	shall
quorum is present shall	be
quorum necessary for the	transaction
quota on the number	of
quotas on the basis	of
quotas on the number	of
quotation at the beginning	of
quotation at the end	of
quotation at the head	of
quotation from a letter	of written
quotation from an article	by
quotation from one of	the his
quotation from the Book	of
quotation from the Old	Testament
quotation from the report	of
quotation from the rest	of
quotation from the writings	of
quotation has already been	made
quotation in critical articles	or
quotation in the text	is
quotation is from a	letter
quotation is taken from	the a
quotation marks and citation	omitted
quotation marks are used	to
quotation marks around the	word
quotation marks at the	beginning
quotation marks to indicate	that
quotation marks to set	off
quotation of brief passages	in
quotation of short passages	for
quotation system of a	registered
quotations are from the	New King Revised Holy
quotations are from this	edition
quotations are taken from	the The this
quotations at the beginning	of
quotations contained herein are	from
quotations embodied in articles	and
quotations embodied in critical	articles reviews
quotations from and references	to
quotations from the Bible	and
quotations from the New	Testament
quotations from the Old	Testament
quotations from the Revised	Standard
quotations from the works	of
quotations from the writings	of
quotations from this work	are
quotations have been taken	from
quotations in an acknowledged	review
quotations in critical articles	or
quotations in critical reviews	or
quotations in reviews for	inclusion
quotations in the New	Testament
quotations in the text	are
quotations in this and	the
quotations in this book	are
quotations in this chapter	are
quotations in this paragraph	are
quotations in this publication	are
quotations in this section	are
quotations that follow are	from
quotations used in this	book
quote a few lines	from
quote a few of	the
quote a few passages	from
quote a few sentences	from
quote a few words	from
quote a passage from	the a
quote at length from	the
quote at some length	from
quote at the beginning	of
quote brief excerpts in	connection
quote brief passages and	reproduce
quote brief passages in	a connection
quote brief passages or	reproduce
quote from a letter	written of
quote from an article	by in
quote from one of	the his
quote from the following	works
quote from the report	of
quote from the works	of
quote from the writings	of
quote is taken from	the
quote once more from	the
quote the exact words	of
quote the following extract	from
quote the following from	the a
quote the following passage	from
quote the language of	the
quote the title of	a
quote the words of	the a an one
quoted a passage from	the
quoted as a percentage	of
quoted as a proof	of
quoted as an authority	on
quoted as an example	of
quoted as an instance	of
quoted as evidence of	the
quoted as having said	that
quoted as one of	the
quoted as saying in	the a
quoted as saying that	the he it if his there a she they in
quoted at length from	the
quoted at length in	the
quoted at the beginning	of
quoted at the end	of
quoted at the head	of
quoted at the opening	of
quoted at the outset	of
quoted at the start	of
quoted by kind permission	of
quoted by permission of	the
quoted by the New	York
quoted by the author	of
quoted earlier in this	chapter
quoted from a letter	written
quoted from one of	the
quoted from the Book	of
quoted from the New	York
quoted from the Old	Testament
quoted from the report	of
quoted from the writings	of
quoted him as saying	that
quoted in New York	Times
quoted in The New	York
quoted in The Wall	Street
quoted in a letter	from
quoted in a previous	chapter
quoted in an article	by
quoted in an earlier	chapter
quoted in connection with	the
quoted in full in	the
quoted in support of	the this
quoted in terms of	the
quoted in the Financial	Times
quoted in the House	of
quoted in the Los	Angeles
quoted in the New	York Testament
quoted in the Report	of
quoted in the Wall	Street
quoted in the Washington	Post
quoted in the beginning	of
quoted in the chapter	on
quoted in the course	of
quoted in the first	chapter
quoted in the following	pages
quoted in the introduction	to
quoted in the last	chapter
quoted in the preceding	chapter paragraph note section
quoted in the press	as
quoted in the previous	chapter section paragraph
quoted in the text	are is of
quoted in this book	are
quoted in this chapter	are
quoted in whole or	in
quoted on a stock	exchange
quoted on the London	Stock
quoted on the New	York
quoted on the Stock	Exchange
quoted on the basis	of
quoted on the stock	exchange
quoted or referred to	in
quoted over and over	again
quoted the case of	a
quoted the following passage	from
quoted the words of	the
quoted to show that	the
quoted to the effect	that
quoted to the same	effect
quoted with approval by	the
quoted with approval the	following
quoted with the permission	of
quotes a long passage	from
quotes a passage from	the a
quotes at length from	the
quotes at the beginning	of
quotes from a letter	of written
quotes him as saying	that
quotes in support of	his
quotes in this paragraph	are
quotes the case of	a
quotes the following from	the
quotes the following passage	from
quotes the words of	the
quotes used in connection	with
quotient is the number	of
quotient obtained by dividing	the
quotient of the number	of
quotient will be the	number
quoting a passage from	the
quoting at length from	the
quoting brief passages for	the
quoting the following passage	from
quoting the words of	the a
